PokerStars Hand #195823241664:  6+ Hold'em No Limit (Button Blind $0.25 - Ante $0.25  USD) - 2019/01/16 18:15:59 EET [2019/01/16 11:15:59 ET]
Table 'Saiph III' 6-max Seat #5 is the button
Seat 2: whattake ($46.94 in chips) 
Seat 5: Egption ($49.48 in chips) 
Seat 6: gaiggibeliin ($50 in chips) 
whattake: posts the ante $0.25
Egption: posts the ante $0.25
gaiggibeliin: posts the ante $0.25
Egption: posts button blind $0.25
*** HOLE CARDS ***
Dealt to gaiggibeliin [6s Jh]
gaiggibeliin: raises $1 to $1.25
whattake: calls $1.25
Egption: calls $1
*** FLOP *** [Jd 6d As]
gaiggibeliin: bets $2.87
whattake: calls $2.87
Egption: raises $10.13 to $13
gaiggibeliin: folds 
whattake: folds 
Uncalled bet ($10.13) returned to Egption
Egption collected $12.45 from pot
*** SUMMARY ***
Total pot $13.11 | Rake $0.66 
Board [Jd 6d As]
Seat 2: whattake folded on the Flop
Seat 5: Egption (button blind) collected ($12.45)
Seat 6: gaiggibeliin folded on the Flop



PokerStars Hand #195823276668:  6+ Hold'em No Limit (Button Blind $0.25 - Ante $0.25  USD) - 2019/01/16 18:16:53 EET [2019/01/16 11:16:53 ET]
Table 'Saiph III' 6-max Seat #6 is the button
Seat 2: whattake ($42.57 in chips) 
Seat 5: Egption ($57.56 in chips) 
Seat 6: gaiggibeliin ($45.63 in chips) 
whattake: posts the ante $0.25
Egption: posts the ante $0.25
gaiggibeliin: posts the ante $0.25
gaiggibeliin: posts button blind $0.25
*** HOLE CARDS ***
Dealt to gaiggibeliin [9s 6d]
whattake: raises $0.30 to $0.55
Egption: folds 
gaiggibeliin: calls $0.30
*** FLOP *** [Js 8c 6c]
whattake: bets $1.41
gaiggibeliin: folds 
Uncalled bet ($1.41) returned to whattake
whattake collected $1.76 from pot
whattake: doesn't show hand 
*** SUMMARY ***
Total pot $1.85 | Rake $0.09 
Board [Js 8c 6c]
Seat 2: whattake collected ($1.76)
Seat 5: Egption folded before Flop (didn't bet)
Seat 6: gaiggibeliin (button blind) folded on the Flop



PokerStars Hand #195823292371:  6+ Hold'em No Limit (Button Blind $0.25 - Ante $0.25  USD) - 2019/01/16 18:17:18 EET [2019/01/16 11:17:18 ET]
Table 'Saiph III' 6-max Seat #2 is the button
Seat 2: whattake ($43.53 in chips) 
Seat 5: Egption ($57.31 in chips) 
Seat 6: gaiggibeliin ($44.83 in chips) 
whattake: posts the ante $0.25
Egption: posts the ante $0.25
gaiggibeliin: posts the ante $0.25
whattake: posts button blind $0.25
*** HOLE CARDS ***
Dealt to gaiggibeliin [Th 7d]
Egption: raises $0.75 to $1
gaiggibeliin: folds 
whattake: calls $0.75
*** FLOP *** [Ad 7s Ks]
Egption: bets $1.50
whattake: calls $1.50
*** TURN *** [Ad 7s Ks] [Ts]
Egption: bets $5.50
whattake: folds 
Uncalled bet ($5.50) returned to Egption
Egption collected $5.46 from pot
*** SUMMARY ***
Total pot $5.75 | Rake $0.29 
Board [Ad 7s Ks Ts]
Seat 2: whattake (button blind) folded on the Turn
Seat 5: Egption collected ($5.46)
Seat 6: gaiggibeliin folded before Flop (didn't bet)



PokerStars Hand #195823313069:  6+ Hold'em No Limit (Button Blind $0.25 - Ante $0.25  USD) - 2019/01/16 18:17:50 EET [2019/01/16 11:17:50 ET]
Table 'Saiph III' 6-max Seat #5 is the button
Seat 2: whattake ($40.78 in chips) 
Seat 5: Egption ($60.02 in chips) 
Seat 6: gaiggibeliin ($44.58 in chips) 
whattake: posts the ante $0.25
Egption: posts the ante $0.25
gaiggibeliin: posts the ante $0.25
Egption: posts button blind $0.25
*** HOLE CARDS ***
Dealt to gaiggibeliin [Ah Kh]
gaiggibeliin: raises $0.75 to $1
whattake: raises $2.50 to $3.50
Egption: folds 
gaiggibeliin: calls $2.50
*** FLOP *** [9c Qh 8s]
gaiggibeliin: checks 
whattake: bets $4
gaiggibeliin: folds 
Uncalled bet ($4) returned to whattake
whattake collected $7.60 from pot
whattake: doesn't show hand 
*** SUMMARY ***
Total pot $8 | Rake $0.40 
Board [9c Qh 8s]
Seat 2: whattake collected ($7.60)
Seat 5: Egption (button blind) folded before Flop
Seat 6: gaiggibeliin folded on the Flop



PokerStars Hand #195823339944:  6+ Hold'em No Limit (Button Blind $0.25 - Ante $0.25  USD) - 2019/01/16 18:18:31 EET [2019/01/16 11:18:31 ET]
Table 'Saiph III' 6-max Seat #6 is the button
Seat 2: whattake ($44.63 in chips) 
Seat 5: Egption ($59.52 in chips) 
Seat 6: gaiggibeliin ($40.83 in chips) 
whattake: posts the ante $0.25
Egption: posts the ante $0.25
gaiggibeliin: posts the ante $0.25
gaiggibeliin: posts button blind $0.25
*** HOLE CARDS ***
Dealt to gaiggibeliin [9h 6c]
whattake: raises $0.30 to $0.55
Egption: raises $2.95 to $3.50
gaiggibeliin: folds 
whattake: calls $2.95
*** FLOP *** [8s Jc 9c]
whattake: checks 
Egption: bets $5.50
whattake: folds 
Uncalled bet ($5.50) returned to Egption
Egption collected $7.60 from pot
*** SUMMARY ***
Total pot $8 | Rake $0.40 
Board [8s Jc 9c]
Seat 2: whattake folded on the Flop
Seat 5: Egption collected ($7.60)
Seat 6: gaiggibeliin (button blind) folded before Flop



PokerStars Hand #195823365862:  6+ Hold'em No Limit (Button Blind $0.25 - Ante $0.25  USD) - 2019/01/16 18:19:11 EET [2019/01/16 11:19:11 ET]
Table 'Saiph III' 6-max Seat #2 is the button
Seat 2: whattake ($40.88 in chips) 
Seat 5: Egption ($63.37 in chips) 
Seat 6: gaiggibeliin ($50 in chips) 
whattake: posts the ante $0.25
Egption: posts the ante $0.25
gaiggibeliin: posts the ante $0.25
whattake: posts button blind $0.25
*** HOLE CARDS ***
Dealt to gaiggibeliin [Js Jd]
Egption: folds 
gaiggibeliin: raises $1 to $1.25
whattake: raises $4 to $5.25
gaiggibeliin: calls $4
*** FLOP *** [7c Td 9c]
gaiggibeliin: checks 
whattake: checks 
*** TURN *** [7c Td 9c] [8c]
gaiggibeliin: bets $3.53
whattake: folds 
Uncalled bet ($3.53) returned to gaiggibeliin
gaiggibeliin collected $10.69 from pot
*** SUMMARY ***
Total pot $11.25 | Rake $0.56 
Board [7c Td 9c 8c]
Seat 2: whattake (button blind) folded on the Turn
Seat 5: Egption folded before Flop (didn't bet)
Seat 6: gaiggibeliin collected ($10.69)



PokerStars Hand #195823390274:  6+ Hold'em No Limit (Button Blind $0.25 - Ante $0.25  USD) - 2019/01/16 18:19:48 EET [2019/01/16 11:19:48 ET]
Table 'Saiph III' 6-max Seat #5 is the button
Seat 2: whattake ($35.38 in chips) 
Seat 5: Egption ($63.12 in chips) 
Seat 6: gaiggibeliin ($55.19 in chips) 
whattake: posts the ante $0.25
Egption: posts the ante $0.25
gaiggibeliin: posts the ante $0.25
Egption: posts button blind $0.25
*** HOLE CARDS ***
Dealt to gaiggibeliin [Th Td]
gaiggibeliin: raises $1 to $1.25
whattake: folds 
Egption: calls $1
*** FLOP *** [Qs Jc Js]
gaiggibeliin: checks 
Egption: checks 
*** TURN *** [Qs Jc Js] [As]
gaiggibeliin: checks 
Egption: checks 
*** RIVER *** [Qs Jc Js As] [9d]
gaiggibeliin: checks 
Egption: checks 
*** SHOW DOWN ***
gaiggibeliin: shows [Th Td] (two pair, Jacks and Tens)
Egption: shows [Kh Qh] (two pair, Queens and Jacks)
Egption collected $3.09 from pot
*** SUMMARY ***
Total pot $3.25 | Rake $0.16 
Board [Qs Jc Js As 9d]
Seat 2: whattake folded before Flop (didn't bet)
Seat 5: Egption (button blind) showed [Kh Qh] and won ($3.09) with two pair, Queens and Jacks
Seat 6: gaiggibeliin showed [Th Td] and lost with two pair, Jacks and Tens



PokerStars Hand #195823434092:  6+ Hold'em No Limit (Button Blind $0.25 - Ante $0.25  USD) - 2019/01/16 18:20:55 EET [2019/01/16 11:20:55 ET]
Table 'Saiph III' 6-max Seat #6 is the button
Seat 2: whattake ($35.13 in chips) 
Seat 5: Egption ($64.71 in chips) 
Seat 6: gaiggibeliin ($53.69 in chips) 
whattake: posts the ante $0.25
Egption: posts the ante $0.25
gaiggibeliin: posts the ante $0.25
gaiggibeliin: posts button blind $0.25
*** HOLE CARDS ***
Dealt to gaiggibeliin [7d Tc]
whattake: raises $0.30 to $0.55
Egption: raises $2.45 to $3
gaiggibeliin: folds 
whattake: calls $2.45
*** FLOP *** [6c 8h 6h]
whattake: checks 
Egption: bets $3
whattake: folds 
Uncalled bet ($3) returned to Egption
Egption collected $6.65 from pot
*** SUMMARY ***
Total pot $7 | Rake $0.35 
Board [6c 8h 6h]
Seat 2: whattake folded on the Flop
Seat 5: Egption collected ($6.65)
Seat 6: gaiggibeliin (button blind) folded before Flop



PokerStars Hand #195823449432:  6+ Hold'em No Limit (Button Blind $0.25 - Ante $0.25  USD) - 2019/01/16 18:21:19 EET [2019/01/16 11:21:19 ET]
Table 'Saiph III' 6-max Seat #2 is the button
Seat 2: whattake ($31.88 in chips) 
Seat 5: Egption ($68.11 in chips) 
Seat 6: gaiggibeliin ($53.19 in chips) 
whattake: posts the ante $0.25
Egption: posts the ante $0.25
gaiggibeliin: posts the ante $0.25
whattake: posts button blind $0.25
*** HOLE CARDS ***
Dealt to gaiggibeliin [7s Ah]
Egption: folds 
gaiggibeliin: calls $0.25
Montana2707 joins the table at seat #4 
whattake: checks 
*** FLOP *** [Kd Ac 9s]
gaiggibeliin: bets $0.62
whattake: calls $0.62
*** TURN *** [Kd Ac 9s] [9c]
barnoculars joins the table at seat #1 
gaiggibeliin: checks 
whattake: checks 
*** RIVER *** [Kd Ac 9s 9c] [8h]
gaiggibeliin: bets $3
whattake: folds 
Uncalled bet ($3) returned to gaiggibeliin
gaiggibeliin collected $2.37 from pot
*** SUMMARY ***
Total pot $2.49 | Rake $0.12 
Board [Kd Ac 9s 9c 8h]
Seat 2: whattake (button blind) folded on the River
Seat 5: Egption folded before Flop (didn't bet)
Seat 6: gaiggibeliin collected ($2.37)



PokerStars Hand #195823475377:  6+ Hold'em No Limit (Button Blind $0.25 - Ante $0.25  USD) - 2019/01/16 18:21:58 EET [2019/01/16 11:21:58 ET]
Table 'Saiph III' 6-max Seat #5 is the button
Seat 1: barnoculars ($50 in chips) 
Seat 2: whattake ($30.76 in chips) 
Seat 4: Montana2707 ($50 in chips) 
Seat 5: Egption ($67.86 in chips) 
Seat 6: gaiggibeliin ($54.44 in chips) 
barnoculars: posts the ante $0.25
whattake: posts the ante $0.25
Montana2707: posts the ante $0.25
Egption: posts the ante $0.25
gaiggibeliin: posts the ante $0.25
Egption: posts button blind $0.25
*** HOLE CARDS ***
Dealt to gaiggibeliin [Ah Tc]
gaiggibeliin: calls $0.25
barnoculars: calls $0.25
whattake: folds 
Montana2707: raises $0.50 to $0.75
Egption: calls $0.50
gaiggibeliin: calls $0.50
barnoculars: calls $0.50
*** FLOP *** [Ad 6c 6s]
gaiggibeliin: checks 
barnoculars: checks 
Montana2707: checks 
Egption: bets $3
gaiggibeliin: folds 
barnoculars: folds 
Montana2707: calls $3
*** TURN *** [Ad 6c 6s] [Ts]
Montana2707: checks 
Egption: bets $11
Montana2707: folds 
Uncalled bet ($11) returned to Egption
Egption collected $9.74 from pot
*** SUMMARY ***
Total pot $10.25 | Rake $0.51 
Board [Ad 6c 6s Ts]
Seat 1: barnoculars folded on the Flop
Seat 2: whattake folded before Flop (didn't bet)
Seat 4: Montana2707 folded on the Turn
Seat 5: Egption (button blind) collected ($9.74)
Seat 6: gaiggibeliin folded on the Flop



PokerStars Hand #195823542574:  6+ Hold'em No Limit (Button Blind $0.25 - Ante $0.25  USD) - 2019/01/16 18:23:39 EET [2019/01/16 11:23:39 ET]
Table 'Saiph III' 6-max Seat #6 is the button
Seat 1: barnoculars ($49 in chips) 
Seat 2: whattake ($30.51 in chips) 
Seat 4: Montana2707 ($50 in chips) 
Seat 5: Egption ($73.60 in chips) 
Seat 6: gaiggibeliin ($53.44 in chips) 
barnoculars: posts the ante $0.25
whattake: posts the ante $0.25
Montana2707: posts the ante $0.25
Egption: posts the ante $0.25
gaiggibeliin: posts the ante $0.25
gaiggibeliin: posts button blind $0.25
*** HOLE CARDS ***
Dealt to gaiggibeliin [Qs Td]
barnoculars: folds 
whattake: raises $2.25 to $2.50
Juodasis_23 joins the table at seat #3 
Montana2707: folds 
Egption: calls $2.50
gaiggibeliin: folds 
*** FLOP *** [6d Th 7d]
whattake: bets $3.21
Egption: calls $3.21
*** TURN *** [6d Th 7d] [9c]
whattake: checks 
Egption: bets $9
whattake: folds 
Uncalled bet ($9) returned to Egption
Egption collected $12.27 from pot
*** SUMMARY ***
Total pot $12.92 | Rake $0.65 
Board [6d Th 7d 9c]
Seat 1: barnoculars folded before Flop (didn't bet)
Seat 2: whattake folded on the Turn
Seat 4: Montana2707 folded before Flop (didn't bet)
Seat 5: Egption collected ($12.27)
Seat 6: gaiggibeliin (button blind) folded before Flop



PokerStars Hand #195823576320:  6+ Hold'em No Limit (Button Blind $0.25 - Ante $0.25  USD) - 2019/01/16 18:24:30 EET [2019/01/16 11:24:30 ET]
Table 'Saiph III' 6-max Seat #1 is the button
Seat 1: barnoculars ($48.75 in chips) 
Seat 2: whattake ($50 in chips) 
Seat 3: Juodasis_23 ($50 in chips) 
Seat 4: Montana2707 ($50 in chips) 
Seat 5: Egption ($79.91 in chips) 
Seat 6: gaiggibeliin ($52.94 in chips) 
barnoculars: posts the ante $0.25
whattake: posts the ante $0.25
Juodasis_23: posts the ante $0.25
Montana2707: posts the ante $0.25
Egption: posts the ante $0.25
gaiggibeliin: posts the ante $0.25
barnoculars: posts button blind $0.25
*** HOLE CARDS ***
Dealt to gaiggibeliin [Jc Qs]
whattake: folds 
Juodasis_23: folds 
Montana2707: folds 
Egption: raises $0.50 to $0.75
gaiggibeliin: calls $0.75
barnoculars: calls $0.50
*** FLOP *** [Kd 6c Js]
Egption: checks 
gaiggibeliin: bets $1.85
barnoculars: calls $1.85
Egption: folds 
*** TURN *** [Kd 6c Js] [Qh]
gaiggibeliin: bets $4.74
barnoculars: folds 
Uncalled bet ($4.74) returned to gaiggibeliin
gaiggibeliin collected $7.08 from pot
*** SUMMARY ***
Total pot $7.45 | Rake $0.37 
Board [Kd 6c Js Qh]
Seat 1: barnoculars (button blind) folded on the Turn
Seat 2: whattake folded before Flop (didn't bet)
Seat 3: Juodasis_23 folded before Flop (didn't bet)
Seat 4: Montana2707 folded before Flop (didn't bet)
Seat 5: Egption folded on the Flop
Seat 6: gaiggibeliin collected ($7.08)



PokerStars Hand #195823656288:  6+ Hold'em No Limit (Button Blind $0.25 - Ante $0.25  USD) - 2019/01/16 18:26:32 EET [2019/01/16 11:26:32 ET]
Table 'Saiph III' 6-max Seat #2 is the button
Seat 1: barnoculars ($45.90 in chips) 
Seat 2: whattake ($49.75 in chips) 
Seat 3: Juodasis_23 ($50 in chips) 
Seat 4: Montana2707 ($50 in chips) 
Seat 5: Egption ($78.91 in chips) 
Seat 6: gaiggibeliin ($57.17 in chips) 
barnoculars: posts the ante $0.25
whattake: posts the ante $0.25
Juodasis_23: posts the ante $0.25
Montana2707: posts the ante $0.25
Egption: posts the ante $0.25
gaiggibeliin: posts the ante $0.25
whattake: posts button blind $0.25
*** HOLE CARDS ***
Dealt to gaiggibeliin [9d Td]
Juodasis_23: raises $0.37 to $0.62
Montana2707: folds 
Egption: folds 
gaiggibeliin: calls $0.62
barnoculars: calls $0.62
whattake: folds 
*** FLOP *** [Th 7d 9c]
Juodasis_23: bets $1.72
gaiggibeliin: raises $5.15 to $6.87
whattake leaves the table
barnoculars: calls $6.87
Juodasis_23: calls $5.15
*** TURN *** [Th 7d 9c] [Qc]
Juodasis_23: checks 
gaiggibeliin: checks 
barnoculars: bets $33.50
Juodasis_23: folds 
gaiggibeliin: folds 
Uncalled bet ($33.50) returned to barnoculars
barnoculars collected $23.01 from pot
barnoculars: doesn't show hand 
*** SUMMARY ***
Total pot $24.22 | Rake $1.21 
Board [Th 7d 9c Qc]
Seat 1: barnoculars collected ($23.01)
Seat 2: whattake (button blind) folded before Flop
Seat 3: Juodasis_23 folded on the Turn
Seat 4: Montana2707 folded before Flop (didn't bet)
Seat 5: Egption folded before Flop (didn't bet)
Seat 6: gaiggibeliin folded on the Turn



PokerStars Hand #195823731184:  6+ Hold'em No Limit (Button Blind $0.25 - Ante $0.25  USD) - 2019/01/16 18:28:25 EET [2019/01/16 11:28:25 ET]
Table 'Saiph III' 6-max Seat #3 is the button
Seat 1: barnoculars ($61.17 in chips) 
Seat 3: Juodasis_23 ($50 in chips) 
Seat 4: Montana2707 ($50 in chips) 
Seat 5: Egption ($78.66 in chips) 
Seat 6: gaiggibeliin ($49.43 in chips) 
barnoculars: posts the ante $0.25
Juodasis_23: posts the ante $0.25
Montana2707: posts the ante $0.25
Egption: posts the ante $0.25
gaiggibeliin: posts the ante $0.25
Juodasis_23: posts button blind $0.25
*** HOLE CARDS ***
Dealt to gaiggibeliin [Ks 7h]
Montana2707: folds 
Egption: raises $1 to $1.25
gaiggibeliin: folds 
barnoculars: calls $1.25
Juodasis_23: folds 
*** FLOP *** [Jh 8s Ts]
Egption: checks 
barnoculars: bets $2.53
Egption: calls $2.53
*** TURN *** [Jh 8s Ts] [6h]
Egption: checks 
barnoculars: bets $5.74
Egption: raises $18.76 to $24.50
barnoculars: calls $18.76
*** RIVER *** [Jh 8s Ts 6h] [Ah]
Egption: bets $50.13 and is all-in
barnoculars: calls $32.64 and is all-in
Uncalled bet ($17.49) returned to Egption
*** SHOW DOWN ***
Egption: shows [Kh Qh] (a flush, Ace high)
barnoculars: shows [8h Th] (a flush, Ace high - lower cards)
Egption collected $121.34 from pot
*** SUMMARY ***
Total pot $123.34 | Rake $2 
Board [Jh 8s Ts 6h Ah]
Seat 1: barnoculars showed [8h Th] and lost with a flush, Ace high
Seat 3: Juodasis_23 (button blind) folded before Flop
Seat 4: Montana2707 folded before Flop (didn't bet)
Seat 5: Egption showed [Kh Qh] and won ($121.34) with a flush, Ace high
Seat 6: gaiggibeliin folded before Flop (didn't bet)



PokerStars Hand #195823803184:  6+ Hold'em No Limit (Button Blind $0.25 - Ante $0.25  USD) - 2019/01/16 18:30:14 EET [2019/01/16 11:30:14 ET]
Table 'Saiph III' 6-max Seat #4 is the button
Seat 3: Juodasis_23 ($50 in chips) 
Seat 4: Montana2707 ($50 in chips) 
Seat 5: Egption ($138.83 in chips) 
Seat 6: gaiggibeliin ($49.18 in chips) 
Juodasis_23: posts the ante $0.25
Montana2707: posts the ante $0.25
Egption: posts the ante $0.25
gaiggibeliin: posts the ante $0.25
Montana2707: posts button blind $0.25
*** HOLE CARDS ***
Dealt to gaiggibeliin [Kd Qs]
Egption: folds 
Pizzaschmied joins the table at seat #2 
gaiggibeliin: raises $1 to $1.25
Juodasis_23: calls $1.25
Montana2707: calls $1
*** FLOP *** [9s Tc Th]
gaiggibeliin: checks 
Juodasis_23: checks 
Montana2707: checks 
*** TURN *** [9s Tc Th] [Jd]
gaiggibeliin: bets $3.02
Juodasis_23: folds 
Montana2707: raises $10.55 to $13.57
gaiggibeliin: folds 
Uncalled bet ($10.55) returned to Montana2707
Montana2707 collected $10.25 from pot
Montana2707: doesn't show hand 
*** SUMMARY ***
Total pot $10.79 | Rake $0.54 
Board [9s Tc Th Jd]
Seat 3: Juodasis_23 folded on the Turn
Seat 4: Montana2707 (button blind) collected ($10.25)
Seat 5: Egption folded before Flop (didn't bet)
Seat 6: gaiggibeliin folded on the Turn



PokerStars Hand #195823866632:  6+ Hold'em No Limit (Button Blind $0.25 - Ante $0.25  USD) - 2019/01/16 18:31:50 EET [2019/01/16 11:31:50 ET]
Table 'Saiph III' 6-max Seat #5 is the button
Seat 1: barnoculars ($50 in chips) 
Seat 2: Pizzaschmied ($50 in chips) 
Seat 3: Juodasis_23 ($50 in chips) 
Seat 4: Montana2707 ($55.73 in chips) 
Seat 5: Egption ($138.58 in chips) 
Seat 6: gaiggibeliin ($44.66 in chips) 
barnoculars: posts the ante $0.25
Pizzaschmied: posts the ante $0.25
Juodasis_23: posts the ante $0.25
Montana2707: posts the ante $0.25
Egption: posts the ante $0.25
gaiggibeliin: posts the ante $0.25
Egption: posts button blind $0.25
*** HOLE CARDS ***
Dealt to gaiggibeliin [Qs 6d]
gaiggibeliin: folds 
barnoculars: folds 
Pizzaschmied: raises $0.50 to $0.75
Juodasis_23: calls $0.75
Montana2707: folds 
Egption: calls $0.50
*** FLOP *** [Th Jd Ks]
Pizzaschmied: checks 
Juodasis_23: checks 
Egption: checks 
*** TURN *** [Th Jd Ks] [9s]
Pizzaschmied: checks 
Juodasis_23: checks 
Egption: checks 
*** RIVER *** [Th Jd Ks 9s] [Td]
Pizzaschmied: checks 
Juodasis_23: bets $3.03
Egption: folds 
Pizzaschmied: calls $3.03
*** SHOW DOWN ***
Juodasis_23: shows [Ts Jh] (a full house, Tens full of Jacks)
Pizzaschmied: mucks hand 
Juodasis_23 collected $9.32 from pot
*** SUMMARY ***
Total pot $9.81 | Rake $0.49 
Board [Th Jd Ks 9s Td]
Seat 1: barnoculars folded before Flop (didn't bet)
Seat 2: Pizzaschmied mucked [9d 9c]
Seat 3: Juodasis_23 showed [Ts Jh] and won ($9.32) with a full house, Tens full of Jacks
Seat 4: Montana2707 folded before Flop (didn't bet)
Seat 5: Egption (button blind) folded on the River
Seat 6: gaiggibeliin folded before Flop (didn't bet)



PokerStars Hand #195823917813:  6+ Hold'em No Limit (Button Blind $0.25 - Ante $0.25  USD) - 2019/01/16 18:33:08 EET [2019/01/16 11:33:08 ET]
Table 'Saiph III' 6-max Seat #6 is the button
Seat 1: barnoculars ($49.75 in chips) 
Seat 2: Pizzaschmied ($45.97 in chips) 
Seat 3: Juodasis_23 ($55.29 in chips) 
Seat 4: Montana2707 ($55.48 in chips) 
Seat 5: Egption ($137.58 in chips) 
Seat 6: gaiggibeliin ($50 in chips) 
barnoculars: posts the ante $0.25
Pizzaschmied: posts the ante $0.25
Juodasis_23: posts the ante $0.25
Montana2707: posts the ante $0.25
Egption: posts the ante $0.25
gaiggibeliin: posts the ante $0.25
gaiggibeliin: posts button blind $0.25
*** HOLE CARDS ***
Dealt to gaiggibeliin [7c 7d]
barnoculars: folds 
Pizzaschmied: raises $0.25 to $0.50
Juodasis_23: folds 
Montana2707: folds 
Egption: raises $2.50 to $3
gaiggibeliin: folds 
Pizzaschmied: calls $2.50
*** FLOP *** [9d Kc Td]
Pizzaschmied: checks 
Egption: checks 
*** TURN *** [9d Kc Td] [8s]
Pizzaschmied: bets $3.68
Egption: folds 
Uncalled bet ($3.68) returned to Pizzaschmied
Pizzaschmied collected $7.36 from pot
Pizzaschmied: doesn't show hand 
*** SUMMARY ***
Total pot $7.75 | Rake $0.39 
Board [9d Kc Td 8s]
Seat 1: barnoculars folded before Flop (didn't bet)
Seat 2: Pizzaschmied collected ($7.36)
Seat 3: Juodasis_23 folded before Flop (didn't bet)
Seat 4: Montana2707 folded before Flop (didn't bet)
Seat 5: Egption folded on the Turn
Seat 6: gaiggibeliin (button blind) folded before Flop



PokerStars Hand #195823944686:  6+ Hold'em No Limit (Button Blind $0.25 - Ante $0.25  USD) - 2019/01/16 18:33:48 EET [2019/01/16 11:33:48 ET]
Table 'Saiph III' 6-max Seat #1 is the button
Seat 1: barnoculars ($49.50 in chips) 
Seat 2: Pizzaschmied ($50.08 in chips) 
Seat 3: Juodasis_23 ($55.04 in chips) 
Seat 4: Montana2707 ($55.23 in chips) 
Seat 5: Egption ($134.33 in chips) 
Seat 6: gaiggibeliin ($49.50 in chips) 
barnoculars: posts the ante $0.25
Pizzaschmied: posts the ante $0.25
Juodasis_23: posts the ante $0.25
Montana2707: posts the ante $0.25
Egption: posts the ante $0.25
gaiggibeliin: posts the ante $0.25
barnoculars: posts button blind $0.25
*** HOLE CARDS ***
Dealt to gaiggibeliin [9d 6h]
Pizzaschmied: raises $0.25 to $0.50
Juodasis_23: folds 
Montana2707: raises $2.75 to $3.25
Egption: folds 
gaiggibeliin: folds 
barnoculars: folds 
Pizzaschmied: calls $2.75
*** FLOP *** [Qh Ad Js]
Pizzaschmied: checks 
Montana2707: checks 
*** TURN *** [Qh Ad Js] [Ac]
Pizzaschmied: checks 
Montana2707: checks 
*** RIVER *** [Qh Ad Js Ac] [Ts]
Pizzaschmied: checks 
Montana2707: bets $3.92
Pizzaschmied: folds 
Uncalled bet ($3.92) returned to Montana2707
Montana2707 collected $7.84 from pot
Montana2707: doesn't show hand 
*** SUMMARY ***
Total pot $8.25 | Rake $0.41 
Board [Qh Ad Js Ac Ts]
Seat 1: barnoculars (button blind) folded before Flop
Seat 2: Pizzaschmied folded on the River
Seat 3: Juodasis_23 folded before Flop (didn't bet)
Seat 4: Montana2707 collected ($7.84)
Seat 5: Egption folded before Flop (didn't bet)
Seat 6: gaiggibeliin folded before Flop (didn't bet)



PokerStars Hand #195823988637:  6+ Hold'em No Limit (Button Blind $0.25 - Ante $0.25  USD) - 2019/01/16 18:34:55 EET [2019/01/16 11:34:55 ET]
Table 'Saiph III' 6-max Seat #2 is the button
Seat 1: barnoculars ($49 in chips) 
Seat 2: Pizzaschmied ($46.58 in chips) 
Seat 3: Juodasis_23 ($54.79 in chips) 
Seat 4: Montana2707 ($59.57 in chips) 
Seat 5: Egption ($134.08 in chips) 
Seat 6: gaiggibeliin ($49.25 in chips) 
barnoculars: posts the ante $0.25
Pizzaschmied: posts the ante $0.25
Juodasis_23: posts the ante $0.25
Montana2707: posts the ante $0.25
Egption: posts the ante $0.25
gaiggibeliin: posts the ante $0.25
Pizzaschmied: posts button blind $0.25
*** HOLE CARDS ***
Dealt to gaiggibeliin [8h Tc]
Juodasis_23: folds 
Montana2707: folds 
Egption: calls $0.25
gaiggibeliin: folds 
barnoculars: raises $2.25 to $2.50
Pizzaschmied: folds 
Egption: calls $2.25
*** FLOP *** [Qd Ah 6s]
Egption: checks 
barnoculars: bets $4.27
Egption: calls $4.27
*** TURN *** [Qd Ah 6s] [Td]
Egption: checks 
barnoculars: bets $9.69
Egption: folds 
Uncalled bet ($9.69) returned to barnoculars
barnoculars collected $14.53 from pot
barnoculars: doesn't show hand 
*** SUMMARY ***
Total pot $15.29 | Rake $0.76 
Board [Qd Ah 6s Td]
Seat 1: barnoculars collected ($14.53)
Seat 2: Pizzaschmied (button blind) folded before Flop
Seat 3: Juodasis_23 folded before Flop (didn't bet)
Seat 4: Montana2707 folded before Flop (didn't bet)
Seat 5: Egption folded on the Turn
Seat 6: gaiggibeliin folded before Flop (didn't bet)



PokerStars Hand #195824029639:  6+ Hold'em No Limit (Button Blind $0.25 - Ante $0.25  USD) - 2019/01/16 18:35:56 EET [2019/01/16 11:35:56 ET]
Table 'Saiph III' 6-max Seat #3 is the button
Seat 1: barnoculars ($56.51 in chips) 
Seat 2: Pizzaschmied ($46.08 in chips) 
Seat 3: Juodasis_23 ($54.54 in chips) 
Seat 4: Montana2707 ($59.32 in chips) 
Seat 5: Egption ($127.06 in chips) 
Seat 6: gaiggibeliin ($49 in chips) 
barnoculars: posts the ante $0.25
Pizzaschmied: posts the ante $0.25
Juodasis_23: posts the ante $0.25
Montana2707: posts the ante $0.25
Egption: posts the ante $0.25
gaiggibeliin: posts the ante $0.25
Juodasis_23: posts button blind $0.25
*** HOLE CARDS ***
Dealt to gaiggibeliin [Js Ks]
Montana2707: raises $0.50 to $0.75
Egption: calls $0.75
gaiggibeliin: calls $0.75
barnoculars: calls $0.75
Pizzaschmied: calls $0.75
Juodasis_23: raises $6.25 to $7
Montana2707: folds 
Egption: folds 
gaiggibeliin: folds 
barnoculars: raises $18.50 to $25.50
Pizzaschmied: folds 
Juodasis_23: raises $28.79 to $54.29 and is all-in
barnoculars: calls $28.79
*** FLOP *** [Qc 9h Kd]
*** TURN *** [Qc 9h Kd] [Ah]
*** RIVER *** [Qc 9h Kd Ah] [Jh]
*** SHOW DOWN ***
barnoculars: shows [Ad 8d] (a pair of Aces)
Juodasis_23: shows [Ac Kh] (two pair, Aces and Kings)
Juodasis_23 collected $111.08 from pot
*** SUMMARY ***
Total pot $113.08 | Rake $2 
Board [Qc 9h Kd Ah Jh]
Seat 1: barnoculars showed [Ad 8d] and lost with a pair of Aces
Seat 2: Pizzaschmied folded before Flop
Seat 3: Juodasis_23 (button blind) showed [Ac Kh] and won ($111.08) with two pair, Aces and Kings
Seat 4: Montana2707 folded before Flop
Seat 5: Egption folded before Flop
Seat 6: gaiggibeliin folded before Flop



PokerStars Hand #195824085249:  6+ Hold'em No Limit (Button Blind $0.25 - Ante $0.25  USD) - 2019/01/16 18:37:20 EET [2019/01/16 11:37:20 ET]
Table 'Saiph III' 6-max Seat #4 is the button
Seat 1: barnoculars ($1.97 in chips) 
Seat 2: Pizzaschmied ($45.08 in chips) 
Seat 3: Juodasis_23 ($111.08 in chips) 
Seat 4: Montana2707 ($58.32 in chips) 
Seat 5: Egption ($126.06 in chips) 
Seat 6: gaiggibeliin ($48 in chips) 
barnoculars: posts the ante $0.25
Pizzaschmied: posts the ante $0.25
Juodasis_23: posts the ante $0.25
Montana2707: posts the ante $0.25
Egption: posts the ante $0.25
gaiggibeliin: posts the ante $0.25
Montana2707: posts button blind $0.25
*** HOLE CARDS ***
Dealt to gaiggibeliin [Jh Kc]
Egption: calls $0.25
gaiggibeliin: folds 
barnoculars: folds 
Pizzaschmied: raises $0.50 to $0.75
Juodasis_23: folds 
Montana2707: folds 
Egption: calls $0.50
*** FLOP *** [Qc 9h 8s]
Egption: checks 
Pizzaschmied: bets $3.09
Egption: raises $8.91 to $12
Pizzaschmied: raises $32.08 to $44.08 and is all-in
Egption: calls $32.08
*** TURN *** [Qc 9h 8s] [As]
*** RIVER *** [Qc 9h 8s As] [7s]
*** SHOW DOWN ***
Egption: shows [Qh 8h] (two pair, Queens and Eights)
Pizzaschmied: shows [Jc Tc] (a straight, Eight to Queen)
Pizzaschmied collected $89.41 from pot
*** SUMMARY ***
Total pot $91.41 | Rake $2 
Board [Qc 9h 8s As 7s]
Seat 1: barnoculars folded before Flop (didn't bet)
Seat 2: Pizzaschmied showed [Jc Tc] and won ($89.41) with a straight, Eight to Queen
Seat 3: Juodasis_23 folded before Flop (didn't bet)
Seat 4: Montana2707 (button blind) folded before Flop
Seat 5: Egption showed [Qh 8h] and lost with two pair, Queens and Eights
Seat 6: gaiggibeliin folded before Flop (didn't bet)



PokerStars Hand #195824118573:  6+ Hold'em No Limit (Button Blind $0.25 - Ante $0.25  USD) - 2019/01/16 18:38:10 EET [2019/01/16 11:38:10 ET]
Table 'Saiph III' 6-max Seat #5 is the button
Seat 1: barnoculars ($50 in chips) 
Seat 2: Pizzaschmied ($89.41 in chips) 
Seat 3: Juodasis_23 ($110.83 in chips) 
Seat 4: Montana2707 ($57.82 in chips) 
Seat 5: Egption ($80.98 in chips) 
Seat 6: gaiggibeliin ($47.75 in chips) 
barnoculars: posts the ante $0.25
Pizzaschmied: posts the ante $0.25
Juodasis_23: posts the ante $0.25
Montana2707: posts the ante $0.25
Egption: posts the ante $0.25
gaiggibeliin: posts the ante $0.25
Egption: posts button blind $0.25
*** HOLE CARDS ***
Dealt to gaiggibeliin [6s As]
gaiggibeliin: folds 
barnoculars: calls $0.25
Pizzaschmied: calls $0.25
Juodasis_23: folds 
Montana2707: raises $0.50 to $0.75
Egption: calls $0.50
barnoculars: calls $0.50
Pizzaschmied: calls $0.50
*** FLOP *** [9c 6h Jc]
barnoculars: checks 
Pizzaschmied: checks 
Montana2707: bets $2.14
Egption: calls $2.14
barnoculars: folds 
Pizzaschmied: folds 
*** TURN *** [9c 6h Jc] [Qc]
Montana2707: checks 
Egption: bets $6
Montana2707: calls $6
*** RIVER *** [9c 6h Jc Qc] [9h]
Montana2707: checks 
Egption: bets $10
Montana2707: raises $38.68 to $48.68 and is all-in
Egption: calls $38.68
*** SHOW DOWN ***
Montana2707: shows [9d Jd] (a full house, Nines full of Jacks)
Egption: shows [Tc Kh] (a straight, Nine to King)
Montana2707 collected $116.14 from pot
*** SUMMARY ***
Total pot $118.14 | Rake $2 
Board [9c 6h Jc Qc 9h]
Seat 1: barnoculars folded on the Flop
Seat 2: Pizzaschmied folded on the Flop
Seat 3: Juodasis_23 folded before Flop (didn't bet)
Seat 4: Montana2707 showed [9d Jd] and won ($116.14) with a full house, Nines full of Jacks
Seat 5: Egption (button blind) showed [Tc Kh] and lost with a straight, Nine to King
Seat 6: gaiggibeliin folded before Flop (didn't bet)



PokerStars Hand #195824201530:  6+ Hold'em No Limit (Button Blind $0.25 - Ante $0.25  USD) - 2019/01/16 18:40:15 EET [2019/01/16 11:40:15 ET]
Table 'Saiph III' 6-max Seat #6 is the button
Seat 1: barnoculars ($50 in chips) 
Seat 2: Pizzaschmied ($88.41 in chips) 
Seat 3: Juodasis_23 ($110.58 in chips) 
Seat 4: Montana2707 ($116.14 in chips) 
Seat 5: Egption ($50 in chips) 
Seat 6: gaiggibeliin ($47.50 in chips) 
barnoculars: posts the ante $0.25
Pizzaschmied: posts the ante $0.25
Juodasis_23: posts the ante $0.25
Montana2707: posts the ante $0.25
Egption: posts the ante $0.25
gaiggibeliin: posts the ante $0.25
gaiggibeliin: posts button blind $0.25
*** HOLE CARDS ***
Dealt to gaiggibeliin [7d 8c]
barnoculars: folds 
Pizzaschmied: raises $0.25 to $0.50
Juodasis_23: folds 
Montana2707: folds 
Egption: raises $2.50 to $3
gaiggibeliin: folds 
Pizzaschmied: calls $2.50
*** FLOP *** [9h Td 6d]
Pizzaschmied: checks 
Egption: bets $5
Pizzaschmied: raises $80.16 to $85.16 and is all-in
Egption: folds 
Uncalled bet ($80.16) returned to Pizzaschmied
Pizzaschmied collected $16.86 from pot
Pizzaschmied: doesn't show hand 
*** SUMMARY ***
Total pot $17.75 | Rake $0.89 
Board [9h Td 6d]
Seat 1: barnoculars folded before Flop (didn't bet)
Seat 2: Pizzaschmied collected ($16.86)
Seat 3: Juodasis_23 folded before Flop (didn't bet)
Seat 4: Montana2707 folded before Flop (didn't bet)
Seat 5: Egption folded on the Flop
Seat 6: gaiggibeliin (button blind) folded before Flop



PokerStars Hand #195824222111:  6+ Hold'em No Limit (Button Blind $0.25 - Ante $0.25  USD) - 2019/01/16 18:40:46 EET [2019/01/16 11:40:46 ET]
Table 'Saiph III' 6-max Seat #1 is the button
Seat 1: barnoculars ($49.75 in chips) 
Seat 2: Pizzaschmied ($97.02 in chips) 
Seat 3: Juodasis_23 ($110.33 in chips) 
Seat 4: Montana2707 ($115.89 in chips) 
Seat 5: Egption ($41.75 in chips) 
Seat 6: gaiggibeliin ($47 in chips) 
barnoculars: posts the ante $0.25
Pizzaschmied: posts the ante $0.25
Juodasis_23: posts the ante $0.25
Montana2707: posts the ante $0.25
Egption: posts the ante $0.25
gaiggibeliin: posts the ante $0.25
barnoculars: posts button blind $0.25
*** HOLE CARDS ***
Dealt to gaiggibeliin [9h Qh]
Pizzaschmied: folds 
Juodasis_23: raises $0.37 to $0.62
Montana2707: folds 
Egption: raises $3.38 to $4
gaiggibeliin: folds 
barnoculars: folds 
Juodasis_23: folds 
Uncalled bet ($3.38) returned to Egption
Egption collected $2.99 from pot
*** SUMMARY ***
Total pot $2.99 | Rake $0 
Seat 1: barnoculars (button blind) folded before Flop
Seat 2: Pizzaschmied folded before Flop (didn't bet)
Seat 3: Juodasis_23 folded before Flop
Seat 4: Montana2707 folded before Flop (didn't bet)
Seat 5: Egption collected ($2.99)
Seat 6: gaiggibeliin folded before Flop (didn't bet)



PokerStars Hand #195824243194:  6+ Hold'em No Limit (Button Blind $0.25 - Ante $0.25  USD) - 2019/01/16 18:41:17 EET [2019/01/16 11:41:17 ET]
Table 'Saiph III' 6-max Seat #2 is the button
Seat 1: barnoculars ($49.25 in chips) 
Seat 2: Pizzaschmied ($96.77 in chips) 
Seat 3: Juodasis_23 ($109.46 in chips) 
Seat 4: Montana2707 ($115.64 in chips) 
Seat 5: Egption ($50 in chips) 
Seat 6: gaiggibeliin ($46.75 in chips) 
barnoculars: posts the ante $0.25
Pizzaschmied: posts the ante $0.25
Juodasis_23: posts the ante $0.25
Montana2707: posts the ante $0.25
Egption: posts the ante $0.25
gaiggibeliin: posts the ante $0.25
Pizzaschmied: posts button blind $0.25
*** HOLE CARDS ***
Dealt to gaiggibeliin [Ac 6s]
Juodasis_23: raises $0.37 to $0.62
Montana2707: calls $0.62
Egption: folds 
Egption leaves the table
gaiggibeliin: folds 
barnoculars: folds 
Pizzaschmied: calls $0.37
*** FLOP *** [Kd Kh 6h]
Juodasis_23: checks 
Montana2707: bets $1.60
Pizzaschmied: folds 
Juodasis_23: folds 
Uncalled bet ($1.60) returned to Montana2707
Montana2707 collected $3.19 from pot
Montana2707: doesn't show hand 
*** SUMMARY ***
Total pot $3.36 | Rake $0.17 
Board [Kd Kh 6h]
Seat 1: barnoculars folded before Flop (didn't bet)
Seat 2: Pizzaschmied (button blind) folded on the Flop
Seat 3: Juodasis_23 folded on the Flop
Seat 4: Montana2707 collected ($3.19)
Seat 5: Egption folded before Flop (didn't bet)
Seat 6: gaiggibeliin folded before Flop (didn't bet)



PokerStars Hand #195824281165:  6+ Hold'em No Limit (Button Blind $0.25 - Ante $0.25  USD) - 2019/01/16 18:42:14 EET [2019/01/16 11:42:14 ET]
Table 'Saiph III' 6-max Seat #3 is the button
Seat 1: barnoculars ($49 in chips) 
Seat 2: Pizzaschmied ($95.90 in chips) 
Seat 3: Juodasis_23 ($108.59 in chips) 
Seat 4: Montana2707 ($117.96 in chips) 
Seat 6: gaiggibeliin ($46.50 in chips) 
barnoculars: posts the ante $0.25
Pizzaschmied: posts the ante $0.25
Juodasis_23: posts the ante $0.25
Montana2707: posts the ante $0.25
gaiggibeliin: posts the ante $0.25
Juodasis_23: posts button blind $0.25
*** HOLE CARDS ***
Dealt to gaiggibeliin [Jc Ks]
Montana2707: folds 
gaiggibeliin: raises $1 to $1.25
barnoculars: folds 
JenzZz221 joins the table at seat #5 
Pizzaschmied: raises $2.25 to $3.50
Juodasis_23: folds 
gaiggibeliin: calls $2.25
*** FLOP *** [7c 9h Kc]
gaiggibeliin: checks 
Pizzaschmied: checks 
*** TURN *** [7c 9h Kc] [Th]
gaiggibeliin: bets $4.20
Pizzaschmied: calls $4.20
*** RIVER *** [7c 9h Kc Th] [Kh]
gaiggibeliin: bets $10.76
Pizzaschmied: calls $10.76
*** SHOW DOWN ***
gaiggibeliin: shows [Jc Ks] (three of a kind, Kings)
Pizzaschmied: mucks hand 
gaiggibeliin collected $36.50 from pot
*** SUMMARY ***
Total pot $38.42 | Rake $1.92 
Board [7c 9h Kc Th Kh]
Seat 1: barnoculars folded before Flop (didn't bet)
Seat 2: Pizzaschmied mucked [9s Ts]
Seat 3: Juodasis_23 (button blind) folded before Flop
Seat 4: Montana2707 folded before Flop (didn't bet)
Seat 6: gaiggibeliin showed [Jc Ks] and won ($36.50) with three of a kind, Kings



PokerStars Hand #195824316373:  6+ Hold'em No Limit (Button Blind $0.25 - Ante $0.25  USD) - 2019/01/16 18:43:07 EET [2019/01/16 11:43:07 ET]
Table 'Saiph III' 6-max Seat #4 is the button
Seat 1: barnoculars ($48.75 in chips) 
Seat 2: Pizzaschmied ($77.19 in chips) 
Seat 3: Juodasis_23 ($108.09 in chips) 
Seat 4: Montana2707 ($117.71 in chips) 
Seat 5: JenzZz221 ($50 in chips) 
Seat 6: gaiggibeliin ($64.29 in chips) 
barnoculars: posts the ante $0.25
Pizzaschmied: posts the ante $0.25
Juodasis_23: posts the ante $0.25
Montana2707: posts the ante $0.25
JenzZz221: posts the ante $0.25
gaiggibeliin: posts the ante $0.25
Montana2707: posts button blind $0.25
*** HOLE CARDS ***
Dealt to gaiggibeliin [6s Kc]
JenzZz221: raises $0.50 to $0.75
gaiggibeliin: folds 
barnoculars: folds 
Pizzaschmied: calls $0.75
Juodasis_23: calls $0.75
Montana2707: calls $0.50
*** FLOP *** [9c 9d 8s]
JenzZz221: checks 
Pizzaschmied: checks 
Juodasis_23: checks 
Montana2707: bets $2.14
JenzZz221: folds 
Pizzaschmied: calls $2.14
Juodasis_23: folds 
*** TURN *** [9c 9d 8s] [8h]
Pizzaschmied: checks 
Montana2707: checks 
*** RIVER *** [9c 9d 8s 8h] [7s]
Pizzaschmied: checks 
Montana2707: checks 
*** SHOW DOWN ***
Pizzaschmied: shows [Jc Tc] (a straight, Seven to Jack)
Montana2707: mucks hand 
Pizzaschmied collected $8.34 from pot
*** SUMMARY ***
Total pot $8.78 | Rake $0.44 
Board [9c 9d 8s 8h 7s]
Seat 1: barnoculars folded before Flop (didn't bet)
Seat 2: Pizzaschmied showed [Jc Tc] and won ($8.34) with a straight, Seven to Jack
Seat 3: Juodasis_23 folded on the Flop
Seat 4: Montana2707 (button blind) mucked [Qh Ts]
Seat 5: JenzZz221 folded on the Flop
Seat 6: gaiggibeliin folded before Flop (didn't bet)



PokerStars Hand #195824364725:  6+ Hold'em No Limit (Button Blind $0.25 - Ante $0.25  USD) - 2019/01/16 18:44:19 EET [2019/01/16 11:44:19 ET]
Table 'Saiph III' 6-max Seat #5 is the button
Seat 1: barnoculars ($48.50 in chips) 
Seat 2: Pizzaschmied ($82.39 in chips) 
Seat 3: Juodasis_23 ($107.09 in chips) 
Seat 4: Montana2707 ($114.57 in chips) 
Seat 5: JenzZz221 ($49 in chips) 
Seat 6: gaiggibeliin ($64.04 in chips) 
barnoculars: posts the ante $0.25
Pizzaschmied: posts the ante $0.25
Juodasis_23: posts the ante $0.25
Montana2707: posts the ante $0.25
JenzZz221: posts the ante $0.25
gaiggibeliin: posts the ante $0.25
JenzZz221: posts button blind $0.25
*** HOLE CARDS ***
Dealt to gaiggibeliin [Js Ac]
gaiggibeliin: raises $1 to $1.25
barnoculars: folds 
Pizzaschmied: calls $1.25
Juodasis_23: folds 
Montana2707: calls $1.25
JenzZz221: calls $1
*** FLOP *** [Ad Th Ks]
gaiggibeliin: checks 
Pizzaschmied: checks 
Montana2707: checks 
JenzZz221: checks 
*** TURN *** [Ad Th Ks] [Jd]
gaiggibeliin: checks 
Pizzaschmied: checks 
Montana2707: checks 
JenzZz221: checks 
*** RIVER *** [Ad Th Ks Jd] [Kc]
gaiggibeliin: checks 
Pizzaschmied: checks 
Montana2707: checks 
JenzZz221: checks 
*** SHOW DOWN ***
gaiggibeliin: shows [Js Ac] (two pair, Aces and Kings)
Pizzaschmied: mucks hand 
Montana2707: mucks hand 
JenzZz221: mucks hand 
gaiggibeliin collected $6.18 from pot
*** SUMMARY ***
Total pot $6.50 | Rake $0.32 
Board [Ad Th Ks Jd Kc]
Seat 1: barnoculars folded before Flop (didn't bet)
Seat 2: Pizzaschmied mucked [9h 6h]
Seat 3: Juodasis_23 folded before Flop (didn't bet)
Seat 4: Montana2707 mucked [9d 7d]
Seat 5: JenzZz221 (button blind) mucked [7s 9s]
Seat 6: gaiggibeliin showed [Js Ac] and won ($6.18) with two pair, Aces and Kings



PokerStars Hand #195824390529:  6+ Hold'em No Limit (Button Blind $0.25 - Ante $0.25  USD) - 2019/01/16 18:44:57 EET [2019/01/16 11:44:57 ET]
Table 'Saiph III' 6-max Seat #6 is the button
Seat 1: barnoculars ($48.25 in chips) 
Seat 2: Pizzaschmied ($80.89 in chips) 
Seat 4: Montana2707 ($113.07 in chips) 
Seat 5: JenzZz221 ($47.50 in chips) 
Seat 6: gaiggibeliin ($68.72 in chips) 
barnoculars: posts the ante $0.25
Pizzaschmied: posts the ante $0.25
Montana2707: posts the ante $0.25
JenzZz221: posts the ante $0.25
gaiggibeliin: posts the ante $0.25
gaiggibeliin: posts button blind $0.25
*** HOLE CARDS ***
Dealt to gaiggibeliin [7h 8h]
barnoculars: folds 
Pizzaschmied: folds 
Montana2707: folds 
JenzZz221: raises $1.75 to $2
gaiggibeliin: calls $1.75
*** FLOP *** [6s 8c 7s]
JenzZz221: bets $3.50
gaiggibeliin: calls $3.50
*** TURN *** [6s 8c 7s] [Ah]
JenzZz221: bets $5.80
gaiggibeliin: calls $5.80
*** RIVER *** [6s 8c 7s Ah] [6d]
JenzZz221: bets $35.95 and is all-in
gaiggibeliin: folds 
Uncalled bet ($35.95) returned to JenzZz221
JenzZz221 collected $22.66 from pot
*** SUMMARY ***
Total pot $23.85 | Rake $1.19 
Board [6s 8c 7s Ah 6d]
Seat 1: barnoculars folded before Flop (didn't bet)
Seat 2: Pizzaschmied folded before Flop (didn't bet)
Seat 4: Montana2707 folded before Flop (didn't bet)
Seat 5: JenzZz221 collected ($22.66)
Seat 6: gaiggibeliin (button blind) folded on the River



PokerStars Hand #195824426308:  6+ Hold'em No Limit (Button Blind $0.25 - Ante $0.25  USD) - 2019/01/16 18:45:50 EET [2019/01/16 11:45:50 ET]
Table 'Saiph III' 6-max Seat #1 is the button
Seat 1: barnoculars ($48 in chips) 
Seat 2: Pizzaschmied ($80.64 in chips) 
Seat 4: Montana2707 ($112.82 in chips) 
Seat 5: JenzZz221 ($58.61 in chips) 
Seat 6: gaiggibeliin ($57.17 in chips) 
barnoculars: posts the ante $0.25
Pizzaschmied: posts the ante $0.25
Montana2707: posts the ante $0.25
JenzZz221: posts the ante $0.25
gaiggibeliin: posts the ante $0.25
barnoculars: posts button blind $0.25
*** HOLE CARDS ***
Dealt to gaiggibeliin [9c Td]
Pizzaschmied: folds 
Montana2707: folds 
JenzZz221: raises $1 to $1.25
gaiggibeliin: folds 
barnoculars: calls $1
*** FLOP *** [9h 7s Ks]
JenzZz221: checks 
barnoculars: checks 
*** TURN *** [9h 7s Ks] [9d]
JenzZz221: checks 
barnoculars: checks 
*** RIVER *** [9h 7s Ks 9d] [7h]
JenzZz221: bets $2
barnoculars: calls $2
*** SHOW DOWN ***
JenzZz221: shows [Jd Qd] (two pair, Nines and Sevens)
barnoculars: shows [7d Qc] (a full house, Sevens full of Nines)
barnoculars collected $7.36 from pot
*** SUMMARY ***
Total pot $7.75 | Rake $0.39 
Board [9h 7s Ks 9d 7h]
Seat 1: barnoculars (button blind) showed [7d Qc] and won ($7.36) with a full house, Sevens full of Nines
Seat 2: Pizzaschmied folded before Flop (didn't bet)
Seat 4: Montana2707 folded before Flop (didn't bet)
Seat 5: JenzZz221 showed [Jd Qd] and lost with two pair, Nines and Sevens
Seat 6: gaiggibeliin folded before Flop (didn't bet)



PokerStars Hand #195824458258:  6+ Hold'em No Limit (Button Blind $0.25 - Ante $0.25  USD) - 2019/01/16 18:46:38 EET [2019/01/16 11:46:38 ET]
Table 'Saiph III' 6-max Seat #2 is the button
Seat 1: barnoculars ($51.86 in chips) 
Seat 2: Pizzaschmied ($80.39 in chips) 
Seat 4: Montana2707 ($112.57 in chips) 
Seat 5: JenzZz221 ($55.11 in chips) 
Seat 6: gaiggibeliin ($56.92 in chips) 
barnoculars: posts the ante $0.25
Pizzaschmied: posts the ante $0.25
Montana2707: posts the ante $0.25
JenzZz221: posts the ante $0.25
gaiggibeliin: posts the ante $0.25
Pizzaschmied: posts button blind $0.25
*** HOLE CARDS ***
Dealt to gaiggibeliin [Jh 8h]
Montana2707: raises $0.50 to $0.75
JenzZz221: raises $1.25 to $2
gaiggibeliin: folds 
barnoculars: folds 
Pizzaschmied: folds 
Montana2707: calls $1.25
*** FLOP *** [9s 7c 8c]
Montana2707: checks 
JenzZz221: bets $2.75
Montana2707: calls $2.75
*** TURN *** [9s 7c 8c] [Th]
Montana2707: checks 
JenzZz221: bets $4.95
Montana2707: calls $4.95
*** RIVER *** [9s 7c 8c Th] [Kd]
Montana2707: checks 
JenzZz221: bets $11.86
Montana2707: calls $11.86
*** SHOW DOWN ***
JenzZz221: shows [Kh Jc] (a straight, Seven to Jack)
Montana2707: mucks hand 
JenzZz221 collected $42.62 from pot
*** SUMMARY ***
Total pot $44.62 | Rake $2 
Board [9s 7c 8c Th Kd]
Seat 1: barnoculars folded before Flop (didn't bet)
Seat 2: Pizzaschmied (button blind) folded before Flop
Seat 4: Montana2707 mucked [7d 9d]
Seat 5: JenzZz221 showed [Kh Jc] and won ($42.62) with a straight, Seven to Jack
Seat 6: gaiggibeliin folded before Flop (didn't bet)



PokerStars Hand #195824506260:  6+ Hold'em No Limit (Button Blind $0.25 - Ante $0.25  USD) - 2019/01/16 18:47:49 EET [2019/01/16 11:47:49 ET]
Table 'Saiph III' 6-max Seat #4 is the button
Seat 1: barnoculars ($51.61 in chips) 
Seat 2: Pizzaschmied ($79.89 in chips) 
Seat 4: Montana2707 ($90.76 in chips) 
Seat 5: JenzZz221 ($75.92 in chips) 
Seat 6: gaiggibeliin ($56.67 in chips) 
barnoculars: posts the ante $0.25
Pizzaschmied: posts the ante $0.25
Montana2707: posts the ante $0.25
JenzZz221: posts the ante $0.25
gaiggibeliin: posts the ante $0.25
Montana2707: posts button blind $0.25
*** HOLE CARDS ***
Dealt to gaiggibeliin [Jd 8c]
JenzZz221: folds 
gaiggibeliin: folds 
barnoculars: raises $1.75 to $2
Pizzaschmied: folds 
Montana2707: folds 
Uncalled bet ($1.75) returned to barnoculars
barnoculars collected $1.75 from pot
barnoculars: doesn't show hand 
*** SUMMARY ***
Total pot $1.75 | Rake $0 
Seat 1: barnoculars collected ($1.75)
Seat 2: Pizzaschmied folded before Flop (didn't bet)
Seat 4: Montana2707 (button blind) folded before Flop
Seat 5: JenzZz221 folded before Flop (didn't bet)
Seat 6: gaiggibeliin folded before Flop (didn't bet)



PokerStars Hand #195824514070:  6+ Hold'em No Limit (Button Blind $0.25 - Ante $0.25  USD) - 2019/01/16 18:48:01 EET [2019/01/16 11:48:01 ET]
Table 'Saiph III' 6-max Seat #6 is the button
Seat 1: barnoculars ($52.86 in chips) 
Seat 2: Pizzaschmied ($79.64 in chips) 
Seat 4: Montana2707 ($90.26 in chips) 
Seat 6: gaiggibeliin ($56.42 in chips) 
barnoculars: posts the ante $0.25
Pizzaschmied: posts the ante $0.25
Montana2707: posts the ante $0.25
gaiggibeliin: posts the ante $0.25
gaiggibeliin: posts button blind $0.25
*** HOLE CARDS ***
Dealt to gaiggibeliin [Js 7c]
barnoculars: folds 
Pizzaschmied: raises $0.50 to $0.75
JenzZz221 leaves the table
Montana2707: calls $0.75
gaiggibeliin: calls $0.50
*** FLOP *** [Tc Qc As]
Pizzaschmied: checks 
Montana2707: checks 
gaiggibeliin: checks 
*** TURN *** [Tc Qc As] [6s]
Pizzaschmied: checks 
Montana2707: bets $1.55
gaiggibeliin: folds 
Pizzaschmied: folds 
Uncalled bet ($1.55) returned to Montana2707
Montana2707 collected $3.09 from pot
redheadmad joins the table at seat #5 
Montana2707: doesn't show hand 
*** SUMMARY ***
Total pot $3.25 | Rake $0.16 
Board [Tc Qc As 6s]
Seat 1: barnoculars folded before Flop (didn't bet)
Seat 2: Pizzaschmied folded on the Turn
Seat 4: Montana2707 collected ($3.09)
Seat 6: gaiggibeliin (button blind) folded on the Turn



PokerStars Hand #195824541342:  6+ Hold'em No Limit (Button Blind $0.25 - Ante $0.25  USD) - 2019/01/16 18:48:41 EET [2019/01/16 11:48:41 ET]
Table 'Saiph III' 6-max Seat #1 is the button
Seat 1: barnoculars ($52.61 in chips) 
Seat 2: Pizzaschmied ($78.64 in chips) 
Seat 4: Montana2707 ($92.35 in chips) 
Seat 5: redheadmad ($50 in chips) 
Seat 6: gaiggibeliin ($55.42 in chips) 
barnoculars: posts the ante $0.25
Pizzaschmied: posts the ante $0.25
Montana2707: posts the ante $0.25
redheadmad: posts the ante $0.25
gaiggibeliin: posts the ante $0.25
barnoculars: posts button blind $0.25
*** HOLE CARDS ***
Dealt to gaiggibeliin [Tc 7h]
Pizzaschmied: raises $0.50 to $0.75
Montana2707: raises $2.75 to $3.50
redheadmad: folds 
gaiggibeliin: folds 
barnoculars: folds 
Pizzaschmied: calls $2.75
*** FLOP *** [Jc Ts 6c]
Pizzaschmied: checks 
Montana2707: bets $4.04
Pizzaschmied: calls $4.04
*** TURN *** [Jc Ts 6c] [Qs]
Pizzaschmied: checks 
Montana2707: bets $7.88
Pizzaschmied: calls $7.88
*** RIVER *** [Jc Ts 6c Qs] [Kc]
Pizzaschmied: bets $62.97 and is all-in
Montana2707: folds 
Uncalled bet ($62.97) returned to Pizzaschmied
Pizzaschmied collected $30.72 from pot
Pizzaschmied: doesn't show hand 
*** SUMMARY ***
Total pot $32.34 | Rake $1.62 
Board [Jc Ts 6c Qs Kc]
Seat 1: barnoculars (button blind) folded before Flop
Seat 2: Pizzaschmied collected ($30.72)
Seat 4: Montana2707 folded on the River
Seat 5: redheadmad folded before Flop (didn't bet)
Seat 6: gaiggibeliin folded before Flop (didn't bet)



PokerStars Hand #195824582220:  6+ Hold'em No Limit (Button Blind $0.25 - Ante $0.25  USD) - 2019/01/16 18:49:42 EET [2019/01/16 11:49:42 ET]
Table 'Saiph III' 6-max Seat #2 is the button
Seat 1: barnoculars ($52.11 in chips) 
Seat 2: Pizzaschmied ($93.69 in chips) 
Seat 4: Montana2707 ($76.68 in chips) 
Seat 5: redheadmad ($50 in chips) 
Seat 6: gaiggibeliin ($55.17 in chips) 
barnoculars: posts the ante $0.25
Pizzaschmied: posts the ante $0.25
Montana2707: posts the ante $0.25
redheadmad: posts the ante $0.25
gaiggibeliin: posts the ante $0.25
Pizzaschmied: posts button blind $0.25
*** HOLE CARDS ***
Dealt to gaiggibeliin [Jh Tc]
Montana2707: folds 
Montana2707 leaves the table
redheadmad: raises $0.25 to $0.50
gaiggibeliin: calls $0.50
barnoculars: folds 
Pizzaschmied: folds 
*** FLOP *** [Ad 9c Jc]
redheadmad: bets $0.86
gaiggibeliin: calls $0.86
*** TURN *** [Ad 9c Jc] [6c]
redheadmad: checks 
gaiggibeliin: checks 
*** RIVER *** [Ad 9c Jc 6c] [Ac]
redheadmad: checks 
gaiggibeliin: bets $6
redheadmad: folds 
Uncalled bet ($6) returned to gaiggibeliin
gaiggibeliin collected $4.01 from pot
*** SUMMARY ***
Total pot $4.22 | Rake $0.21 
Board [Ad 9c Jc 6c Ac]
Seat 1: barnoculars folded before Flop (didn't bet)
Seat 2: Pizzaschmied (button blind) folded before Flop
Seat 4: Montana2707 folded before Flop (didn't bet)
Seat 5: redheadmad folded on the River
Seat 6: gaiggibeliin collected ($4.01)



PokerStars Hand #195824629044:  6+ Hold'em No Limit (Button Blind $0.25 - Ante $0.25  USD) - 2019/01/16 18:50:51 EET [2019/01/16 11:50:51 ET]
Table 'Saiph III' 6-max Seat #5 is the button
Seat 1: barnoculars ($51.86 in chips) 
Seat 2: Pizzaschmied ($93.19 in chips) 
Seat 5: redheadmad ($50 in chips) 
Seat 6: gaiggibeliin ($57.57 in chips) 
barnoculars: posts the ante $0.25
Pizzaschmied: posts the ante $0.25
redheadmad: posts the ante $0.25
gaiggibeliin: posts the ante $0.25
redheadmad: posts button blind $0.25
*** HOLE CARDS ***
Dealt to gaiggibeliin [Kc 6c]
gaiggibeliin: folds 
Galaktyczni joins the table at seat #4 
barnoculars: folds 
Pizzaschmied: raises $0.25 to $0.50
redheadmad: calls $0.25
*** FLOP *** [7c 6d 9h]
Pizzaschmied: checks 
redheadmad: bets $1.54
Pizzaschmied: calls $1.54
*** TURN *** [7c 6d 9h] [8c]
Pizzaschmied: checks 
redheadmad: checks 
*** RIVER *** [7c 6d 9h 8c] [Ad]
Pizzaschmied: checks 
redheadmad: checks 
*** SHOW DOWN ***
Pizzaschmied: shows [Ac 6h] (a straight, Ace to Nine)
redheadmad: shows [Js 6s] (a straight, Ace to Nine)
Pizzaschmied collected $2.42 from pot
redheadmad collected $2.41 from pot
*** SUMMARY ***
Total pot $5.08 | Rake $0.25 
Board [7c 6d 9h 8c Ad]
Seat 1: barnoculars folded before Flop (didn't bet)
Seat 2: Pizzaschmied showed [Ac 6h] and won ($2.42) with a straight, Ace to Nine
Seat 5: redheadmad (button blind) showed [Js 6s] and won ($2.41) with a straight, Ace to Nine
Seat 6: gaiggibeliin folded before Flop (didn't bet)



PokerStars Hand #195824646134:  6+ Hold'em No Limit (Button Blind $0.25 - Ante $0.25  USD) - 2019/01/16 18:51:16 EET [2019/01/16 11:51:16 ET]
Table 'Saiph III' 6-max Seat #6 is the button
Seat 1: barnoculars ($51.61 in chips) 
Seat 2: Pizzaschmied ($93.32 in chips) 
Seat 4: Galaktyczni ($50 in chips) 
Seat 5: redheadmad ($50.12 in chips) 
Seat 6: gaiggibeliin ($57.32 in chips) 
barnoculars: posts the ante $0.25
Pizzaschmied: posts the ante $0.25
Galaktyczni: posts the ante $0.25
redheadmad: posts the ante $0.25
gaiggibeliin: posts the ante $0.25
gaiggibeliin: posts button blind $0.25
*** HOLE CARDS ***
Dealt to gaiggibeliin [Qs 8d]
barnoculars: folds 
Pizzaschmied is disconnected 
Pizzaschmied is connected 
Pizzaschmied: raises $0.50 to $0.75
Galaktyczni: folds 
redheadmad: raises $2.22 to $2.97
gaiggibeliin: folds 
Pizzaschmied: calls $2.22
*** FLOP *** [Qc 9h Ac]
Pizzaschmied: checks 
redheadmad: bets $4.75
Pizzaschmied: calls $4.75
*** TURN *** [Qc 9h Ac] [Kh]
Pizzaschmied: checks 
redheadmad: checks 
*** RIVER *** [Qc 9h Ac Kh] [Js]
Pizzaschmied: checks 
redheadmad: checks 
*** SHOW DOWN ***
Pizzaschmied: shows [Jd Td] (a straight, Ten to Ace)
redheadmad: mucks hand 
Pizzaschmied collected $16.09 from pot
*** SUMMARY ***
Total pot $16.94 | Rake $0.85 
Board [Qc 9h Ac Kh Js]
Seat 1: barnoculars folded before Flop (didn't bet)
Seat 2: Pizzaschmied showed [Jd Td] and won ($16.09) with a straight, Ten to Ace
Seat 4: Galaktyczni folded before Flop (didn't bet)
Seat 5: redheadmad mucked [Qh As]
Seat 6: gaiggibeliin (button blind) folded before Flop



PokerStars Hand #195824705986:  6+ Hold'em No Limit (Button Blind $0.25 - Ante $0.25  USD) - 2019/01/16 18:52:45 EET [2019/01/16 11:52:45 ET]
Table 'Saiph III' 6-max Seat #1 is the button
Seat 1: barnoculars ($51.36 in chips) 
Seat 2: Pizzaschmied ($101.44 in chips) 
Seat 4: Galaktyczni ($49.75 in chips) 
Seat 5: redheadmad ($50 in chips) 
Seat 6: gaiggibeliin ($56.82 in chips) 
barnoculars: posts the ante $0.25
Pizzaschmied: posts the ante $0.25
Galaktyczni: posts the ante $0.25
redheadmad: posts the ante $0.25
gaiggibeliin: posts the ante $0.25
barnoculars: posts button blind $0.25
*** HOLE CARDS ***
Dealt to gaiggibeliin [Ad 8h]
Pizzaschmied: folds 
Galaktyczni: folds 
redheadmad: raises $1.75 to $2
gaiggibeliin: folds 
barnoculars: folds 
Uncalled bet ($1.75) returned to redheadmad
redheadmad collected $1.75 from pot
*** SUMMARY ***
Total pot $1.75 | Rake $0 
Seat 1: barnoculars (button blind) folded before Flop
Seat 2: Pizzaschmied folded before Flop (didn't bet)
Seat 4: Galaktyczni folded before Flop (didn't bet)
Seat 5: redheadmad collected ($1.75)
Seat 6: gaiggibeliin folded before Flop (didn't bet)



PokerStars Hand #195824718758:  6+ Hold'em No Limit (Button Blind $0.25 - Ante $0.25  USD) - 2019/01/16 18:53:04 EET [2019/01/16 11:53:04 ET]
Table 'Saiph III' 6-max Seat #2 is the button
Seat 1: barnoculars ($50.86 in chips) 
Seat 2: Pizzaschmied ($101.19 in chips) 
Seat 4: Galaktyczni ($49.50 in chips) 
Seat 5: redheadmad ($51.25 in chips) 
Seat 6: gaiggibeliin ($56.57 in chips) 
barnoculars: posts the ante $0.25
Pizzaschmied: posts the ante $0.25
Galaktyczni: posts the ante $0.25
redheadmad: posts the ante $0.25
gaiggibeliin: posts the ante $0.25
Pizzaschmied: posts button blind $0.25
*** HOLE CARDS ***
Dealt to gaiggibeliin [Kd 6c]
Galaktyczni: raises $0.50 to $0.75
redheadmad: folds 
gaiggibeliin: folds 
barnoculars: folds 
Pizzaschmied: folds 
Uncalled bet ($0.50) returned to Galaktyczni
Galaktyczni collected $1.75 from pot
Galaktyczni: doesn't show hand 
*** SUMMARY ***
Total pot $1.75 | Rake $0 
Seat 1: barnoculars folded before Flop (didn't bet)
Seat 2: Pizzaschmied (button blind) folded before Flop
Seat 4: Galaktyczni collected ($1.75)
Seat 5: redheadmad folded before Flop (didn't bet)
Seat 6: gaiggibeliin folded before Flop (didn't bet)



PokerStars Hand #195824724402:  6+ Hold'em No Limit (Button Blind $0.25 - Ante $0.25  USD) - 2019/01/16 18:53:12 EET [2019/01/16 11:53:12 ET]
Table 'Saiph III' 6-max Seat #4 is the button
Seat 1: barnoculars ($50.61 in chips) 
Seat 2: Pizzaschmied ($100.69 in chips) 
Seat 4: Galaktyczni ($50.75 in chips) 
Seat 5: redheadmad ($51 in chips) 
Seat 6: gaiggibeliin ($56.32 in chips) 
barnoculars: posts the ante $0.25
Pizzaschmied: posts the ante $0.25
Galaktyczni: posts the ante $0.25
redheadmad: posts the ante $0.25
gaiggibeliin: posts the ante $0.25
Galaktyczni: posts button blind $0.25
*** HOLE CARDS ***
Dealt to gaiggibeliin [Qc Tc]
redheadmad: folds 
gaiggibeliin: raises $1 to $1.25
barnoculars: calls $1.25
Pizzaschmied: folds 
Galaktyczni: folds 
*** FLOP *** [6d Qd Td]
gaiggibeliin: bets $2.85
barnoculars: calls $2.85
*** TURN *** [6d Qd Td] [Ts]
gaiggibeliin: checks 
barnoculars: bets $6.15
gaiggibeliin: calls $6.15
*** RIVER *** [6d Qd Td Ts] [Th]
gaiggibeliin: checks 
barnoculars: checks 
*** SHOW DOWN ***
gaiggibeliin: shows [Qc Tc] (four of a kind, Tens)
barnoculars: mucks hand 
gaiggibeliin collected $20.90 from pot
*** SUMMARY ***
Total pot $22 | Rake $1.10 
Board [6d Qd Td Ts Th]
Seat 1: barnoculars mucked [Jh Kh]
Seat 2: Pizzaschmied folded before Flop (didn't bet)
Seat 4: Galaktyczni (button blind) folded before Flop
Seat 5: redheadmad folded before Flop (didn't bet)
Seat 6: gaiggibeliin showed [Qc Tc] and won ($20.90) with four of a kind, Tens



PokerStars Hand #195824776198:  6+ Hold'em No Limit (Button Blind $0.25 - Ante $0.25  USD) - 2019/01/16 18:54:29 EET [2019/01/16 11:54:29 ET]
Table 'Saiph III' 6-max Seat #5 is the button
Seat 1: barnoculars ($40.11 in chips) 
Seat 2: Pizzaschmied ($100.44 in chips) 
Seat 4: Galaktyczni ($50.25 in chips) 
Seat 5: redheadmad ($50.75 in chips) 
Seat 6: gaiggibeliin ($66.72 in chips) 
barnoculars: posts the ante $0.25
Pizzaschmied: posts the ante $0.25
Galaktyczni: posts the ante $0.25
redheadmad: posts the ante $0.25
gaiggibeliin: posts the ante $0.25
redheadmad: posts button blind $0.25
*** HOLE CARDS ***
Dealt to gaiggibeliin [8c Ac]
gaiggibeliin: calls $0.25
barnoculars: calls $0.25
Pizzaschmied: folds 
Galaktyczni: raises $0.75 to $1
redheadmad: folds 
gaiggibeliin: calls $0.75
barnoculars: calls $0.75
*** FLOP *** [8h 6d Qs]
gaiggibeliin: bets $2.23
barnoculars: raises $5.83 to $8.06
Galaktyczni: folds 
gaiggibeliin: folds 
Uncalled bet ($5.83) returned to barnoculars
barnoculars collected $8.51 from pot
barnoculars: doesn't show hand 
*** SUMMARY ***
Total pot $8.96 | Rake $0.45 
Board [8h 6d Qs]
Seat 1: barnoculars collected ($8.51)
Seat 2: Pizzaschmied folded before Flop (didn't bet)
Seat 4: Galaktyczni folded on the Flop
Seat 5: redheadmad (button blind) folded before Flop
Seat 6: gaiggibeliin folded on the Flop



PokerStars Hand #195824801783:  6+ Hold'em No Limit (Button Blind $0.25 - Ante $0.25  USD) - 2019/01/16 18:55:08 EET [2019/01/16 11:55:08 ET]
Table 'Saiph III' 6-max Seat #6 is the button
Seat 1: barnoculars ($50 in chips) 
Seat 2: Pizzaschmied ($100.19 in chips) 
Seat 4: Galaktyczni ($49 in chips) 
Seat 5: redheadmad ($50.25 in chips) 
Seat 6: gaiggibeliin ($63.24 in chips) 
barnoculars: posts the ante $0.25
Pizzaschmied: posts the ante $0.25
Galaktyczni: posts the ante $0.25
redheadmad: posts the ante $0.25
gaiggibeliin: posts the ante $0.25
gaiggibeliin: posts button blind $0.25
*** HOLE CARDS ***
Dealt to gaiggibeliin [7h Kc]
barnoculars: calls $0.25
Pizzaschmied: folds 
Galaktyczni: folds 
redheadmad: folds 
gaiggibeliin: checks 
*** FLOP *** [Th Js Jh]
barnoculars: checks 
gaiggibeliin: checks 
*** TURN *** [Th Js Jh] [6c]
barnoculars: bets $1.11
gaiggibeliin: folds 
Uncalled bet ($1.11) returned to barnoculars
barnoculars collected $1.66 from pot
barnoculars: doesn't show hand 
*** SUMMARY ***
Total pot $1.75 | Rake $0.09 
Board [Th Js Jh 6c]
Seat 1: barnoculars collected ($1.66)
Seat 2: Pizzaschmied folded before Flop (didn't bet)
Seat 4: Galaktyczni folded before Flop (didn't bet)
Seat 5: redheadmad folded before Flop (didn't bet)
Seat 6: gaiggibeliin (button blind) folded on the Turn



PokerStars Hand #195824818193:  6+ Hold'em No Limit (Button Blind $0.25 - Ante $0.25  USD) - 2019/01/16 18:55:37 EET [2019/01/16 11:55:37 ET]
Table 'Saiph III' 6-max Seat #1 is the button
Seat 1: barnoculars ($51.16 in chips) 
Seat 2: Pizzaschmied ($99.94 in chips) 
Seat 4: Galaktyczni ($48.75 in chips) 
Seat 5: redheadmad ($50 in chips) 
Seat 6: gaiggibeliin ($62.74 in chips) 
barnoculars: posts the ante $0.25
Pizzaschmied: posts the ante $0.25
Galaktyczni: posts the ante $0.25
redheadmad: posts the ante $0.25
gaiggibeliin: posts the ante $0.25
barnoculars: posts button blind $0.25
*** HOLE CARDS ***
Dealt to gaiggibeliin [Th Jc]
Pizzaschmied: folds 
Galaktyczni: raises $0.50 to $0.75
redheadmad: folds 
gaiggibeliin: calls $0.75
barnoculars: calls $0.50
*** FLOP *** [6d Ks Tc]
Galaktyczni: bets $2.22
gaiggibeliin: folds 
barnoculars: calls $2.22
*** TURN *** [6d Ks Tc] [Qs]
Galaktyczni: checks 
barnoculars: bets $5.03
Galaktyczni: folds 
Uncalled bet ($5.03) returned to barnoculars
barnoculars collected $7.54 from pot
barnoculars: doesn't show hand 
*** SUMMARY ***
Total pot $7.94 | Rake $0.40 
Board [6d Ks Tc Qs]
Seat 1: barnoculars (button blind) collected ($7.54)
Seat 2: Pizzaschmied folded before Flop (didn't bet)
Seat 4: Galaktyczni folded on the Turn
Seat 5: redheadmad folded before Flop (didn't bet)
Seat 6: gaiggibeliin folded on the Flop



PokerStars Hand #195824843609:  6+ Hold'em No Limit (Button Blind $0.25 - Ante $0.25  USD) - 2019/01/16 18:56:24 EET [2019/01/16 11:56:24 ET]
Table 'Saiph III' 6-max Seat #2 is the button
Seat 1: barnoculars ($55.48 in chips) 
Seat 2: Pizzaschmied ($99.69 in chips) 
Seat 4: Galaktyczni ($45.53 in chips) 
Seat 5: redheadmad ($50 in chips) 
Seat 6: gaiggibeliin ($61.74 in chips) 
barnoculars: posts the ante $0.25
Pizzaschmied: posts the ante $0.25
Galaktyczni: posts the ante $0.25
redheadmad: posts the ante $0.25
gaiggibeliin: posts the ante $0.25
Pizzaschmied: posts button blind $0.25
*** HOLE CARDS ***
Dealt to gaiggibeliin [8c As]
Galaktyczni: folds 
redheadmad: raises $0.25 to $0.50
gaiggibeliin: folds 
barnoculars: calls $0.50
Pizzaschmied: calls $0.25
*** FLOP *** [6d Js Kc]
redheadmad: bets $0.94
barnoculars: calls $0.94
Pizzaschmied: calls $0.94
*** TURN *** [6d Js Kc] [6c]
redheadmad: checks 
barnoculars: bets $3.97
Pizzaschmied: folds 
redheadmad: folds 
Uncalled bet ($3.97) returned to barnoculars
barnoculars collected $5.29 from pot
barnoculars: doesn't show hand 
*** SUMMARY ***
Total pot $5.57 | Rake $0.28 
Board [6d Js Kc 6c]
Seat 1: barnoculars collected ($5.29)
Seat 2: Pizzaschmied (button blind) folded on the Turn
Seat 4: Galaktyczni folded before Flop (didn't bet)
Seat 5: redheadmad folded on the Turn
Seat 6: gaiggibeliin folded before Flop (didn't bet)



PokerStars Hand #195824871789:  6+ Hold'em No Limit (Button Blind $0.25 - Ante $0.25  USD) - 2019/01/16 18:57:15 EET [2019/01/16 11:57:15 ET]
Table 'Saiph III' 6-max Seat #4 is the button
Seat 1: barnoculars ($59.08 in chips) 
Seat 2: Pizzaschmied ($98 in chips) 
Seat 4: Galaktyczni ($45.28 in chips) 
Seat 5: redheadmad ($50 in chips) 
Seat 6: gaiggibeliin ($61.49 in chips) 
barnoculars: posts the ante $0.25
Pizzaschmied: posts the ante $0.25
Galaktyczni: posts the ante $0.25
redheadmad: posts the ante $0.25
gaiggibeliin: posts the ante $0.25
Galaktyczni: posts button blind $0.25
*** HOLE CARDS ***
Dealt to gaiggibeliin [Qh Jd]
redheadmad: raises $0.50 to $0.75
gaiggibeliin: folds 
barnoculars: folds 
Pizzaschmied: folds 
Galaktyczni: folds 
Uncalled bet ($0.50) returned to redheadmad
redheadmad collected $1.75 from pot
*** SUMMARY ***
Total pot $1.75 | Rake $0 
Seat 1: barnoculars folded before Flop (didn't bet)
Seat 2: Pizzaschmied folded before Flop (didn't bet)
Seat 4: Galaktyczni (button blind) folded before Flop
Seat 5: redheadmad collected ($1.75)
Seat 6: gaiggibeliin folded before Flop (didn't bet)



PokerStars Hand #195824881638:  6+ Hold'em No Limit (Button Blind $0.25 - Ante $0.25  USD) - 2019/01/16 18:57:33 EET [2019/01/16 11:57:33 ET]
Table 'Saiph III' 6-max Seat #5 is the button
Seat 1: barnoculars ($58.83 in chips) 
Seat 2: Pizzaschmied ($97.75 in chips) 
Seat 4: Galaktyczni ($44.78 in chips) 
Seat 5: redheadmad ($51.25 in chips) 
Seat 6: gaiggibeliin ($61.24 in chips) 
barnoculars: posts the ante $0.25
Pizzaschmied: posts the ante $0.25
Galaktyczni: posts the ante $0.25
redheadmad: posts the ante $0.25
gaiggibeliin: posts the ante $0.25
redheadmad: posts button blind $0.25
*** HOLE CARDS ***
Dealt to gaiggibeliin [8d Js]
gaiggibeliin: folds 
barnoculars: folds 
Pizzaschmied: folds 
Galaktyczni: raises $0.50 to $0.75
redheadmad: calls $0.50
*** FLOP *** [Ad 6c Qd]
Galaktyczni: checks 
redheadmad: checks 
*** TURN *** [Ad 6c Qd] [Ah]
Galaktyczni: checks 
redheadmad: checks 
*** RIVER *** [Ad 6c Qd Ah] [Jd]
Galaktyczni: checks 
redheadmad: checks 
*** SHOW DOWN ***
Galaktyczni: shows [7d 8c] (a pair of Aces)
redheadmad: shows [8h Qh] (two pair, Aces and Queens)
redheadmad collected $2.61 from pot
*** SUMMARY ***
Total pot $2.75 | Rake $0.14 
Board [Ad 6c Qd Ah Jd]
Seat 1: barnoculars folded before Flop (didn't bet)
Seat 2: Pizzaschmied folded before Flop (didn't bet)
Seat 4: Galaktyczni showed [7d 8c] and lost with a pair of Aces
Seat 5: redheadmad (button blind) showed [8h Qh] and won ($2.61) with two pair, Aces and Queens
Seat 6: gaiggibeliin folded before Flop (didn't bet)



PokerStars Hand #195824905334:  6+ Hold'em No Limit (Button Blind $0.25 - Ante $0.25  USD) - 2019/01/16 18:58:16 EET [2019/01/16 11:58:16 ET]
Table 'Saiph III' 6-max Seat #6 is the button
Seat 1: barnoculars ($58.58 in chips) 
Seat 2: Pizzaschmied ($97.50 in chips) 
Seat 4: Galaktyczni ($43.78 in chips) 
Seat 5: redheadmad ($52.86 in chips) 
Seat 6: gaiggibeliin ($60.99 in chips) 
barnoculars: posts the ante $0.25
Pizzaschmied: posts the ante $0.25
Galaktyczni: posts the ante $0.25
redheadmad: posts the ante $0.25
gaiggibeliin: posts the ante $0.25
gaiggibeliin: posts button blind $0.25
*** HOLE CARDS ***
Dealt to gaiggibeliin [6c Ks]
barnoculars: folds 
Pizzaschmied: folds 
Galaktyczni: raises $0.50 to $0.75
redheadmad: raises $3 to $3.75
gaiggibeliin: folds 
Galaktyczni: folds 
Uncalled bet ($3) returned to redheadmad
redheadmad collected $3 from pot
*** SUMMARY ***
Total pot $3 | Rake $0 
Seat 1: barnoculars folded before Flop (didn't bet)
Seat 2: Pizzaschmied folded before Flop (didn't bet)
Seat 4: Galaktyczni folded before Flop
Seat 5: redheadmad collected ($3)
Seat 6: gaiggibeliin (button blind) folded before Flop



PokerStars Hand #195824916672:  6+ Hold'em No Limit (Button Blind $0.25 - Ante $0.25  USD) - 2019/01/16 18:58:36 EET [2019/01/16 11:58:36 ET]
Table 'Saiph III' 6-max Seat #1 is the button
Seat 1: barnoculars ($58.33 in chips) 
Seat 2: Pizzaschmied ($97.25 in chips) 
Seat 4: Galaktyczni ($42.78 in chips) 
Seat 5: redheadmad ($54.86 in chips) 
Seat 6: gaiggibeliin ($60.49 in chips) 
barnoculars: posts the ante $0.25
Pizzaschmied: posts the ante $0.25
Galaktyczni: posts the ante $0.25
redheadmad: posts the ante $0.25
gaiggibeliin: posts the ante $0.25
barnoculars: posts button blind $0.25
*** HOLE CARDS ***
Dealt to gaiggibeliin [9s Ad]
Pizzaschmied: raises $0.25 to $0.50
Galaktyczni: calls $0.50
redheadmad: folds 
gaiggibeliin: folds 
barnoculars: calls $0.25
*** FLOP *** [Qc Jc Jd]
Pizzaschmied: bets $1.31
Galaktyczni: calls $1.31
barnoculars: folds 
*** TURN *** [Qc Jc Jd] [Tc]
Pizzaschmied: checks 
Galaktyczni: checks 
*** RIVER *** [Qc Jc Jd Tc] [8c]
Pizzaschmied: checks 
Galaktyczni: bets $3.50
Pizzaschmied: calls $3.50
*** SHOW DOWN ***
Galaktyczni: shows [8d Qd] (two pair, Queens and Jacks)
Pizzaschmied: shows [Ts Kc] (a flush, King high)
Pizzaschmied collected $11.75 from pot
*** SUMMARY ***
Total pot $12.37 | Rake $0.62 
Board [Qc Jc Jd Tc 8c]
Seat 1: barnoculars (button blind) folded on the Flop
Seat 2: Pizzaschmied showed [Ts Kc] and won ($11.75) with a flush, King high
Seat 4: Galaktyczni showed [8d Qd] and lost with two pair, Queens and Jacks
Seat 5: redheadmad folded before Flop (didn't bet)
Seat 6: gaiggibeliin folded before Flop (didn't bet)



PokerStars Hand #195824938904:  6+ Hold'em No Limit (Button Blind $0.25 - Ante $0.25  USD) - 2019/01/16 18:59:16 EET [2019/01/16 11:59:16 ET]
Table 'Saiph III' 6-max Seat #2 is the button
Seat 1: barnoculars ($57.58 in chips) 
Seat 2: Pizzaschmied ($103.44 in chips) 
Seat 4: Galaktyczni ($37.22 in chips) 
Seat 5: redheadmad ($54.61 in chips) 
Seat 6: gaiggibeliin ($60.24 in chips) 
barnoculars: posts the ante $0.25
Pizzaschmied: posts the ante $0.25
Galaktyczni: posts the ante $0.25
redheadmad: posts the ante $0.25
gaiggibeliin: posts the ante $0.25
Pizzaschmied: posts button blind $0.25
*** HOLE CARDS ***
Dealt to gaiggibeliin [Ad 6s]
Galaktyczni: folds 
redheadmad: raises $0.31 to $0.56
gaiggibeliin: folds 
barnoculars: calls $0.56
Pizzaschmied: folds 
*** FLOP *** [Qh 9d Kd]
redheadmad: bets $0.90
barnoculars: raises $2.15 to $3.05
redheadmad: folds 
Uncalled bet ($2.15) returned to barnoculars
barnoculars collected $4.20 from pot
barnoculars: doesn't show hand 
*** SUMMARY ***
Total pot $4.42 | Rake $0.22 
Board [Qh 9d Kd]
Seat 1: barnoculars collected ($4.20)
Seat 2: Pizzaschmied (button blind) folded before Flop
Seat 4: Galaktyczni folded before Flop (didn't bet)
Seat 5: redheadmad folded on the Flop
Seat 6: gaiggibeliin folded before Flop (didn't bet)



PokerStars Hand #195824961184:  6+ Hold'em No Limit (Button Blind $0.25 - Ante $0.25  USD) - 2019/01/16 18:59:57 EET [2019/01/16 11:59:57 ET]
Table 'Saiph III' 6-max Seat #4 is the button
Seat 1: barnoculars ($60.07 in chips) 
Seat 2: Pizzaschmied ($102.94 in chips) 
Seat 4: Galaktyczni ($46.97 in chips) 
Seat 5: redheadmad ($52.90 in chips) 
Seat 6: gaiggibeliin ($59.99 in chips) 
barnoculars: posts the ante $0.25
Pizzaschmied: posts the ante $0.25
Galaktyczni: posts the ante $0.25
redheadmad: posts the ante $0.25
gaiggibeliin: posts the ante $0.25
Galaktyczni: posts button blind $0.25
*** HOLE CARDS ***
Dealt to gaiggibeliin [Qd Ad]
redheadmad: folds 
gaiggibeliin: raises $1.75 to $2
barnoculars: calls $2
Pizzaschmied: calls $2
Galaktyczni: raises $44.72 to $46.72 and is all-in
gaiggibeliin: folds 
barnoculars: folds 
Pizzaschmied: folds 
Uncalled bet ($44.72) returned to Galaktyczni
Galaktyczni collected $9.25 from pot
Juodasis_23 was removed from the table for failing to post
Juodasis_23 leaves the table
Galaktyczni: doesn't show hand 
*** SUMMARY ***
Total pot $9.25 | Rake $0 
Seat 1: barnoculars folded before Flop
Seat 2: Pizzaschmied folded before Flop
Seat 4: Galaktyczni (button blind) collected ($9.25)
Seat 5: redheadmad folded before Flop (didn't bet)
Seat 6: gaiggibeliin folded before Flop



PokerStars Hand #195824978687:  6+ Hold'em No Limit (Button Blind $0.25 - Ante $0.25  USD) - 2019/01/16 19:00:27 EET [2019/01/16 12:00:27 ET]
Table 'Saiph III' 6-max Seat #5 is the button
Seat 1: barnoculars ($57.82 in chips) 
Seat 2: Pizzaschmied ($100.69 in chips) 
Seat 4: Galaktyczni ($53.97 in chips) 
Seat 5: redheadmad ($52.65 in chips) 
Seat 6: gaiggibeliin ($57.74 in chips) 
barnoculars: posts the ante $0.25
Pizzaschmied: posts the ante $0.25
Galaktyczni: posts the ante $0.25
redheadmad: posts the ante $0.25
gaiggibeliin: posts the ante $0.25
redheadmad: posts button blind $0.25
*** HOLE CARDS ***
Dealt to gaiggibeliin [Kc Ks]
gaiggibeliin: raises $1.75 to $2
barnoculars: folds 
Pizzaschmied: calls $2
Galaktyczni: folds 
redheadmad: folds 
*** FLOP *** [Ts Jd 8d]
gaiggibeliin: checks 
Pizzaschmied: checks 
*** TURN *** [Ts Jd 8d] [Qs]
gaiggibeliin: checks 
zarepokerboy joins the table at seat #3 
Pizzaschmied: checks 
*** RIVER *** [Ts Jd 8d Qs] [7d]
gaiggibeliin: checks 
Pizzaschmied: checks 
*** SHOW DOWN ***
gaiggibeliin: shows [Kc Ks] (a pair of Kings)
Pizzaschmied: shows [Qd Qc] (three of a kind, Queens)
Pizzaschmied collected $5.22 from pot
*** SUMMARY ***
Total pot $5.50 | Rake $0.28 
Board [Ts Jd 8d Qs 7d]
Seat 1: barnoculars folded before Flop (didn't bet)
Seat 2: Pizzaschmied showed [Qd Qc] and won ($5.22) with three of a kind, Queens
Seat 4: Galaktyczni folded before Flop (didn't bet)
Seat 5: redheadmad (button blind) folded before Flop
Seat 6: gaiggibeliin showed [Kc Ks] and lost with a pair of Kings



PokerStars Hand #195824997768:  6+ Hold'em No Limit (Button Blind $0.25 - Ante $0.25  USD) - 2019/01/16 19:00:59 EET [2019/01/16 12:00:59 ET]
Table 'Saiph III' 6-max Seat #6 is the button
Seat 1: barnoculars ($57.57 in chips) 
Seat 2: Pizzaschmied ($103.66 in chips) 
Seat 3: zarepokerboy ($50 in chips) 
Seat 4: Galaktyczni ($53.72 in chips) 
Seat 5: redheadmad ($52.15 in chips) 
Seat 6: gaiggibeliin ($55.49 in chips) 
barnoculars: posts the ante $0.25
Pizzaschmied: posts the ante $0.25
zarepokerboy: posts the ante $0.25
Galaktyczni: posts the ante $0.25
redheadmad: posts the ante $0.25
gaiggibeliin: posts the ante $0.25
gaiggibeliin: posts button blind $0.25
*** HOLE CARDS ***
Dealt to gaiggibeliin [9s 7h]
barnoculars: folds 
Pizzaschmied: folds 
zarepokerboy: raises $0.50 to $0.75
Galaktyczni: folds 
redheadmad: folds 
gaiggibeliin: calls $0.50
*** FLOP *** [Tc Jc 8c]
zarepokerboy: bets $1.85
gaiggibeliin: calls $1.85
*** TURN *** [Tc Jc 8c] [8h]
zarepokerboy: bets $4.25
gaiggibeliin: calls $4.25
*** RIVER *** [Tc Jc 8c 8h] [9h]
zarepokerboy: bets $42.90 and is all-in
gaiggibeliin: folds 
Uncalled bet ($42.90) returned to zarepokerboy
zarepokerboy collected $14.44 from pot
*** SUMMARY ***
Total pot $15.20 | Rake $0.76 
Board [Tc Jc 8c 8h 9h]
Seat 1: barnoculars folded before Flop (didn't bet)
Seat 2: Pizzaschmied folded before Flop (didn't bet)
Seat 3: zarepokerboy collected ($14.44)
Seat 4: Galaktyczni folded before Flop (didn't bet)
Seat 5: redheadmad folded before Flop (didn't bet)
Seat 6: gaiggibeliin (button blind) folded on the River



PokerStars Hand #195825051891:  6+ Hold'em No Limit (Button Blind $0.25 - Ante $0.25  USD) - 2019/01/16 19:02:21 EET [2019/01/16 12:02:21 ET]
Table 'Saiph III' 6-max Seat #1 is the button
Seat 1: barnoculars ($57.32 in chips) 
Seat 2: Pizzaschmied ($103.41 in chips) 
Seat 3: zarepokerboy ($57.34 in chips) 
Seat 4: Galaktyczni ($53.47 in chips) 
Seat 5: redheadmad ($51.90 in chips) 
Seat 6: gaiggibeliin ($48.39 in chips) 
barnoculars: posts the ante $0.25
Pizzaschmied: posts the ante $0.25
zarepokerboy: posts the ante $0.25
Galaktyczni: posts the ante $0.25
redheadmad: posts the ante $0.25
gaiggibeliin: posts the ante $0.25
barnoculars: posts button blind $0.25
*** HOLE CARDS ***
Dealt to gaiggibeliin [6c Th]
Pizzaschmied: folds 
zarepokerboy: folds 
Galaktyczni: raises $0.50 to $0.75
redheadmad: folds 
gaiggibeliin: folds 
barnoculars: calls $0.50
*** FLOP *** [Ac Td 8h]
Galaktyczni: checks 
barnoculars: checks 
*** TURN *** [Ac Td 8h] [Jd]
Galaktyczni: checks 
barnoculars: checks 
*** RIVER *** [Ac Td 8h Jd] [9c]
Galaktyczni: checks 
barnoculars: checks 
*** SHOW DOWN ***
Galaktyczni: shows [Kc Kd] (a pair of Kings)
barnoculars: mucks hand 
Galaktyczni collected $2.85 from pot
*** SUMMARY ***
Total pot $3 | Rake $0.15 
Board [Ac Td 8h Jd 9c]
Seat 1: barnoculars (button blind) mucked [Ks 6d]
Seat 2: Pizzaschmied folded before Flop (didn't bet)
Seat 3: zarepokerboy folded before Flop (didn't bet)
Seat 4: Galaktyczni showed [Kc Kd] and won ($2.85) with a pair of Kings
Seat 5: redheadmad folded before Flop (didn't bet)
Seat 6: gaiggibeliin folded before Flop (didn't bet)



PokerStars Hand #195825082762:  6+ Hold'em No Limit (Button Blind $0.25 - Ante $0.25  USD) - 2019/01/16 19:03:07 EET [2019/01/16 12:03:07 ET]
Table 'Saiph III' 6-max Seat #2 is the button
Seat 1: barnoculars ($56.32 in chips) 
Seat 2: Pizzaschmied ($103.16 in chips) 
Seat 3: zarepokerboy ($57.09 in chips) 
Seat 4: Galaktyczni ($55.32 in chips) 
Seat 5: redheadmad ($51.65 in chips) 
Seat 6: gaiggibeliin ($48.14 in chips) 
barnoculars: posts the ante $0.25
Pizzaschmied: posts the ante $0.25
zarepokerboy: posts the ante $0.25
Galaktyczni: posts the ante $0.25
redheadmad: posts the ante $0.25
gaiggibeliin: posts the ante $0.25
Pizzaschmied: posts button blind $0.25
*** HOLE CARDS ***
Dealt to gaiggibeliin [Jd Ac]
zarepokerboy: folds 
Galaktyczni: raises $0.50 to $0.75
zarepokerboy leaves the table
redheadmad: raises $2.41 to $3.16
gaiggibeliin: folds 
barnoculars: folds 
Pizzaschmied: folds 
Galaktyczni: calls $2.41
*** FLOP *** [9d Kh 6d]
Galaktyczni: checks 
redheadmad: bets $4.68
Galaktyczni: calls $4.68
*** TURN *** [9d Kh 6d] [7s]
Galaktyczni: checks 
redheadmad: bets $13.41
Galaktyczni: calls $13.41
*** RIVER *** [9d Kh 6d 7s] [9s]
Galaktyczni: bets $33.82 and is all-in
redheadmad: calls $30.15 and is all-in
Uncalled bet ($3.67) returned to Galaktyczni
*** SHOW DOWN ***
Galaktyczni: shows [Qc Tc] (a pair of Nines)
redheadmad: shows [Kd Qd] (two pair, Kings and Nines)
redheadmad collected $102.55 from pot
*** SUMMARY ***
Total pot $104.55 | Rake $2 
Board [9d Kh 6d 7s 9s]
Seat 1: barnoculars folded before Flop (didn't bet)
Seat 2: Pizzaschmied (button blind) folded before Flop
Seat 3: zarepokerboy folded before Flop (didn't bet)
Seat 4: Galaktyczni showed [Qc Tc] and lost with a pair of Nines
Seat 5: redheadmad showed [Kd Qd] and won ($102.55) with two pair, Kings and Nines
Seat 6: gaiggibeliin folded before Flop (didn't bet)



PokerStars Hand #195825140507:  6+ Hold'em No Limit (Button Blind $0.25 - Ante $0.25  USD) - 2019/01/16 19:04:32 EET [2019/01/16 12:04:32 ET]
Table 'Saiph III' 6-max Seat #4 is the button
Seat 1: barnoculars ($56.07 in chips) 
Seat 2: Pizzaschmied ($102.66 in chips) 
Seat 4: Galaktyczni ($50 in chips) 
Seat 5: redheadmad ($102.55 in chips) 
Seat 6: gaiggibeliin ($47.89 in chips) 
barnoculars: posts the ante $0.25
Pizzaschmied: posts the ante $0.25
Galaktyczni: posts the ante $0.25
redheadmad: posts the ante $0.25
gaiggibeliin: posts the ante $0.25
Galaktyczni: posts button blind $0.25
*** HOLE CARDS ***
Dealt to gaiggibeliin [Qc Jd]
redheadmad: raises $0.56 to $0.81
gaiggibeliin: folds 
barnoculars: calls $0.81
Pizzaschmied: calls $0.81
Galaktyczni: calls $0.56
*** FLOP *** [Ac Qh 8c]
redheadmad: checks 
barnoculars: checks 
Pizzaschmied: checks 
Galaktyczni: checks 
*** TURN *** [Ac Qh 8c] [9s]
redheadmad: checks 
barnoculars: bets $2.85
Pizzaschmied: folds 
bumts1bum joins the table at seat #3 
Galaktyczni: calls $2.85
redheadmad: folds 
*** RIVER *** [Ac Qh 8c 9s] [8s]
barnoculars: checks 
Galaktyczni: checks 
*** SHOW DOWN ***
barnoculars: shows [Qd Kc] (two pair, Queens and Eights)
Galaktyczni: shows [Jh Ad] (two pair, Aces and Eights)
Galaktyczni collected $9.68 from pot
*** SUMMARY ***
Total pot $10.19 | Rake $0.51 
Board [Ac Qh 8c 9s 8s]
Seat 1: barnoculars showed [Qd Kc] and lost with two pair, Queens and Eights
Seat 2: Pizzaschmied folded on the Turn
Seat 4: Galaktyczni (button blind) showed [Jh Ad] and won ($9.68) with two pair, Aces and Eights
Seat 5: redheadmad folded on the Turn
Seat 6: gaiggibeliin folded before Flop (didn't bet)



PokerStars Hand #195825183302:  6+ Hold'em No Limit (Button Blind $0.25 - Ante $0.25  USD) - 2019/01/16 19:05:34 EET [2019/01/16 12:05:34 ET]
Table 'Saiph III' 6-max Seat #5 is the button
Seat 1: barnoculars ($52.16 in chips) 
Seat 2: Pizzaschmied ($101.60 in chips) 
Seat 3: bumts1bum ($50 in chips) 
Seat 4: Galaktyczni ($55.77 in chips) 
Seat 5: redheadmad ($101.49 in chips) 
Seat 6: gaiggibeliin ($47.64 in chips) 
barnoculars: posts the ante $0.25
Pizzaschmied: posts the ante $0.25
bumts1bum: posts the ante $0.25
Galaktyczni: posts the ante $0.25
redheadmad: posts the ante $0.25
gaiggibeliin: posts the ante $0.25
redheadmad: posts button blind $0.25
*** HOLE CARDS ***
Dealt to gaiggibeliin [Ad 9h]
gaiggibeliin: folds 
barnoculars: calls $0.25
Pizzaschmied: calls $0.25
bumts1bum: calls $0.25
Galaktyczni: folds 
redheadmad: raises $2.50 to $2.75
barnoculars: raises $7.50 to $10.25
Pizzaschmied: folds 
bumts1bum: folds 
redheadmad: folds 
Uncalled bet ($7.50) returned to barnoculars
barnoculars collected $7.50 from pot
barnoculars: doesn't show hand 
*** SUMMARY ***
Total pot $7.50 | Rake $0 
Seat 1: barnoculars collected ($7.50)
Seat 2: Pizzaschmied folded before Flop
Seat 3: bumts1bum folded before Flop
Seat 4: Galaktyczni folded before Flop (didn't bet)
Seat 5: redheadmad (button blind) folded before Flop
Seat 6: gaiggibeliin folded before Flop (didn't bet)



PokerStars Hand #195825209236:  6+ Hold'em No Limit (Button Blind $0.25 - Ante $0.25  USD) - 2019/01/16 19:06:11 EET [2019/01/16 12:06:11 ET]
Table 'Saiph III' 6-max Seat #6 is the button
Seat 1: barnoculars ($56.66 in chips) 
Seat 2: Pizzaschmied ($101.10 in chips) 
Seat 3: bumts1bum ($49.50 in chips) 
Seat 4: Galaktyczni ($55.52 in chips) 
Seat 6: gaiggibeliin ($47.39 in chips) 
barnoculars: posts the ante $0.25
Pizzaschmied: posts the ante $0.25
bumts1bum: posts the ante $0.25
Galaktyczni: posts the ante $0.25
gaiggibeliin: posts the ante $0.25
gaiggibeliin: posts button blind $0.25
*** HOLE CARDS ***
Dealt to gaiggibeliin [Qs 6h]
barnoculars: calls $0.25
Pizzaschmied: folds 
bumts1bum: calls $0.25
Galaktyczni: folds 
gaiggibeliin: checks 
*** FLOP *** [Ks 9h Kh]
redheadmad leaves the table
barnoculars: bets $1.27
bumts1bum: folds 
gaiggibeliin: folds 
Uncalled bet ($1.27) returned to barnoculars
barnoculars collected $1.90 from pot
barnoculars: doesn't show hand 
Roosinups joins the table at seat #5 
*** SUMMARY ***
Total pot $2 | Rake $0.10 
Board [Ks 9h Kh]
Seat 1: barnoculars collected ($1.90)
Seat 2: Pizzaschmied folded before Flop (didn't bet)
Seat 3: bumts1bum folded on the Flop
Seat 4: Galaktyczni folded before Flop (didn't bet)
Seat 6: gaiggibeliin (button blind) folded on the Flop



PokerStars Hand #195825225309:  6+ Hold'em No Limit (Button Blind $0.25 - Ante $0.25  USD) - 2019/01/16 19:06:35 EET [2019/01/16 12:06:35 ET]
Table 'Saiph III' 6-max Seat #1 is the button
Seat 1: barnoculars ($58.06 in chips) 
Seat 2: Pizzaschmied ($100.85 in chips) 
Seat 3: bumts1bum ($49 in chips) 
Seat 4: Galaktyczni ($55.27 in chips) 
Seat 5: Roosinups ($50 in chips) 
Seat 6: gaiggibeliin ($46.89 in chips) 
barnoculars: posts the ante $0.25
Pizzaschmied: posts the ante $0.25
bumts1bum: posts the ante $0.25
Galaktyczni: posts the ante $0.25
Roosinups: posts the ante $0.25
gaiggibeliin: posts the ante $0.25
barnoculars: posts button blind $0.25
*** HOLE CARDS ***
Dealt to gaiggibeliin [6h 8s]
Pizzaschmied: folds 
bumts1bum: folds 
Galaktyczni: raises $0.50 to $0.75
Roosinups: calls $0.75
gaiggibeliin: folds 
barnoculars: calls $0.50
*** FLOP *** [Qc Jd 9d]
Galaktyczni: checks 
Roosinups: bets $1.75
barnoculars: raises $5.30 to $7.05
Galaktyczni: folds 
Roosinups: calls $5.30
*** TURN *** [Qc Jd 9d] [Tc]
Roosinups: bets $10
barnoculars: folds 
Uncalled bet ($10) returned to Roosinups
Roosinups collected $16.96 from pot
Roosinups: doesn't show hand 
*** SUMMARY ***
Total pot $17.85 | Rake $0.89 
Board [Qc Jd 9d Tc]
Seat 1: barnoculars (button blind) folded on the Turn
Seat 2: Pizzaschmied folded before Flop (didn't bet)
Seat 3: bumts1bum folded before Flop (didn't bet)
Seat 4: Galaktyczni folded on the Flop
Seat 5: Roosinups collected ($16.96)
Seat 6: gaiggibeliin folded before Flop (didn't bet)



PokerStars Hand #195825277827:  6+ Hold'em No Limit (Button Blind $0.25 - Ante $0.25  USD) - 2019/01/16 19:07:49 EET [2019/01/16 12:07:49 ET]
Table 'Saiph III' 6-max Seat #2 is the button
Seat 1: barnoculars ($50.01 in chips) 
Seat 2: Pizzaschmied ($100.60 in chips) 
Seat 3: bumts1bum ($48.75 in chips) 
Seat 4: Galaktyczni ($54.27 in chips) 
Seat 5: Roosinups ($58.91 in chips) 
Seat 6: gaiggibeliin ($46.64 in chips) 
barnoculars: posts the ante $0.25
Pizzaschmied: posts the ante $0.25
bumts1bum: posts the ante $0.25
Galaktyczni: posts the ante $0.25
Roosinups: posts the ante $0.25
gaiggibeliin: posts the ante $0.25
Pizzaschmied: posts button blind $0.25
*** HOLE CARDS ***
Dealt to gaiggibeliin [6d Kd]
bumts1bum: folds 
Galaktyczni: raises $0.50 to $0.75
Roosinups: calls $0.75
gaiggibeliin: folds 
barnoculars: raises $4 to $4.75
Pizzaschmied: raises $95.60 to $100.35 and is all-in
Galaktyczni: folds 
Roosinups: folds 
barnoculars: folds 
Uncalled bet ($95.60) returned to Pizzaschmied
Pizzaschmied collected $12.50 from pot
Pizzaschmied: doesn't show hand 
*** SUMMARY ***
Total pot $12.50 | Rake $0 
Seat 1: barnoculars folded before Flop
Seat 2: Pizzaschmied (button blind) collected ($12.50)
Seat 3: bumts1bum folded before Flop (didn't bet)
Seat 4: Galaktyczni folded before Flop
Seat 5: Roosinups folded before Flop
Seat 6: gaiggibeliin folded before Flop (didn't bet)



PokerStars Hand #195825304579:  6+ Hold'em No Limit (Button Blind $0.25 - Ante $0.25  USD) - 2019/01/16 19:08:28 EET [2019/01/16 12:08:28 ET]
Table 'Saiph III' 6-max Seat #3 is the button
Seat 1: barnoculars ($50 in chips) 
Seat 2: Pizzaschmied ($108.10 in chips) 
Seat 3: bumts1bum ($48.50 in chips) 
Seat 4: Galaktyczni ($53.27 in chips) 
Seat 5: Roosinups ($57.91 in chips) 
Seat 6: gaiggibeliin ($46.39 in chips) 
barnoculars: posts the ante $0.25
Pizzaschmied: posts the ante $0.25
bumts1bum: posts the ante $0.25
Galaktyczni: posts the ante $0.25
Roosinups: posts the ante $0.25
gaiggibeliin: posts the ante $0.25
bumts1bum: posts button blind $0.25
*** HOLE CARDS ***
Dealt to gaiggibeliin [Ac 7s]
Galaktyczni: raises $0.50 to $0.75
Roosinups: folds 
gaiggibeliin: folds 
barnoculars: folds 
Pizzaschmied: folds 
bumts1bum: calls $0.50
*** FLOP *** [Js 9h 7c]
Galaktyczni: checks 
bumts1bum: bets $2
Galaktyczni: calls $2
*** TURN *** [Js 9h 7c] [Qc]
Galaktyczni: checks 
bumts1bum: bets $3.25
Galaktyczni: calls $3.25
*** RIVER *** [Js 9h 7c Qc] [9s]
Galaktyczni: checks 
bumts1bum: bets $4
Galaktyczni: raises $10.41 to $14.41
bumts1bum: calls $10.41
*** SHOW DOWN ***
Galaktyczni: shows [Th Ad] (a pair of Nines)
bumts1bum: shows [Td 8d] (a straight, Eight to Queen)
bumts1bum collected $40.32 from pot
*** SUMMARY ***
Total pot $42.32 | Rake $2 
Board [Js 9h 7c Qc 9s]
Seat 1: barnoculars folded before Flop (didn't bet)
Seat 2: Pizzaschmied folded before Flop (didn't bet)
Seat 3: bumts1bum (button blind) showed [Td 8d] and won ($40.32) with a straight, Eight to Queen
Seat 4: Galaktyczni showed [Th Ad] and lost with a pair of Nines
Seat 5: Roosinups folded before Flop (didn't bet)
Seat 6: gaiggibeliin folded before Flop (didn't bet)



PokerStars Hand #195825325297:  6+ Hold'em No Limit (Button Blind $0.25 - Ante $0.25  USD) - 2019/01/16 19:08:58 EET [2019/01/16 12:08:58 ET]
Table 'Saiph III' 6-max Seat #4 is the button
Seat 1: barnoculars ($49.75 in chips) 
Seat 2: Pizzaschmied ($107.85 in chips) 
Seat 3: bumts1bum ($68.16 in chips) 
Seat 4: Galaktyczni ($32.61 in chips) 
Seat 5: Roosinups ($57.66 in chips) 
Seat 6: gaiggibeliin ($46.14 in chips) 
barnoculars: posts the ante $0.25
Pizzaschmied: posts the ante $0.25
bumts1bum: posts the ante $0.25
Galaktyczni: posts the ante $0.25
Roosinups: posts the ante $0.25
gaiggibeliin: posts the ante $0.25
Galaktyczni: posts button blind $0.25
*** HOLE CARDS ***
Dealt to gaiggibeliin [Tc 8h]
Roosinups: folds 
gaiggibeliin: folds 
barnoculars: folds 
Pizzaschmied: raises $0.25 to $0.50
bumts1bum: calls $0.50
Galaktyczni: calls $0.25
*** FLOP *** [Kc 7h Jh]
Pizzaschmied: checks 
bumts1bum: checks 
Galaktyczni: bets $1.43
Pizzaschmied: calls $1.43
bumts1bum: folds 
*** TURN *** [Kc 7h Jh] [9d]
Pizzaschmied: checks 
Galaktyczni: checks 
*** RIVER *** [Kc 7h Jh 9d] [8c]
Pizzaschmied: checks 
Galaktyczni: bets $3.73
Pizzaschmied: calls $3.73
*** SHOW DOWN ***
Galaktyczni: shows [Kd Th] (a straight, Seven to Jack)
Pizzaschmied: mucks hand 
Galaktyczni collected $12.65 from pot
*** SUMMARY ***
Total pot $13.32 | Rake $0.67 
Board [Kc 7h Jh 9d 8c]
Seat 1: barnoculars folded before Flop (didn't bet)
Seat 2: Pizzaschmied mucked [Ac Jc]
Seat 3: bumts1bum folded on the Flop
Seat 4: Galaktyczni (button blind) showed [Kd Th] and won ($12.65) with a straight, Seven to Jack
Seat 5: Roosinups folded before Flop (didn't bet)
Seat 6: gaiggibeliin folded before Flop (didn't bet)



PokerStars Hand #195825348299:  6+ Hold'em No Limit (Button Blind $0.25 - Ante $0.25  USD) - 2019/01/16 19:09:31 EET [2019/01/16 12:09:31 ET]
Table 'Saiph III' 6-max Seat #5 is the button
Seat 1: barnoculars ($49.50 in chips) 
Seat 2: Pizzaschmied ($101.94 in chips) 
Seat 3: bumts1bum ($67.41 in chips) 
Seat 4: Galaktyczni ($39.35 in chips) 
Seat 5: Roosinups ($57.41 in chips) 
Seat 6: gaiggibeliin ($50 in chips) 
barnoculars: posts the ante $0.25
Pizzaschmied: posts the ante $0.25
bumts1bum: posts the ante $0.25
Galaktyczni: posts the ante $0.25
Roosinups: posts the ante $0.25
gaiggibeliin: posts the ante $0.25
Roosinups: posts button blind $0.25
*** HOLE CARDS ***
Dealt to gaiggibeliin [Kc 6h]
gaiggibeliin: folds 
barnoculars: folds 
Pizzaschmied: raises $0.25 to $0.50
bumts1bum: calls $0.50
Galaktyczni: raises $3.25 to $3.75
Roosinups: folds 
Pizzaschmied: calls $3.25
bumts1bum: calls $3.25
*** FLOP *** [Js 9d 8d]
Pizzaschmied: checks 
bumts1bum: checks 
Galaktyczni: checks 
*** TURN *** [Js 9d 8d] [Kh]
Pizzaschmied: checks 
bumts1bum: bets $6.50
Galaktyczni: calls $6.50
Pizzaschmied: folds 
*** RIVER *** [Js 9d 8d Kh] [9s]
bumts1bum: checks 
Galaktyczni: bets $28.85 and is all-in
bumts1bum: calls $28.85
*** SHOW DOWN ***
Galaktyczni: shows [Ad As] (two pair, Aces and Nines)
bumts1bum: shows [7s Tc] (a straight, Seven to Jack)
bumts1bum collected $81.70 from pot
*** SUMMARY ***
Total pot $83.70 | Rake $2 
Board [Js 9d 8d Kh 9s]
Seat 1: barnoculars folded before Flop (didn't bet)
Seat 2: Pizzaschmied folded on the Turn
Seat 3: bumts1bum showed [7s Tc] and won ($81.70) with a straight, Seven to Jack
Seat 4: Galaktyczni showed [Ad As] and lost with two pair, Aces and Nines
Seat 5: Roosinups (button blind) folded before Flop
Seat 6: gaiggibeliin folded before Flop (didn't bet)



PokerStars Hand #195825381333:  6+ Hold'em No Limit (Button Blind $0.25 - Ante $0.25  USD) - 2019/01/16 19:10:18 EET [2019/01/16 12:10:18 ET]
Table 'Saiph III' 6-max Seat #6 is the button
Seat 1: barnoculars ($49.25 in chips) 
Seat 2: Pizzaschmied ($97.94 in chips) 
Seat 3: bumts1bum ($109.76 in chips) 
Seat 4: Galaktyczni ($50 in chips) 
Seat 5: Roosinups ($56.91 in chips) 
Seat 6: gaiggibeliin ($49.75 in chips) 
barnoculars: posts the ante $0.25
Pizzaschmied: posts the ante $0.25
bumts1bum: posts the ante $0.25
Galaktyczni: posts the ante $0.25
Roosinups: posts the ante $0.25
gaiggibeliin: posts the ante $0.25
gaiggibeliin: posts button blind $0.25
*** HOLE CARDS ***
Dealt to gaiggibeliin [7h 6h]
barnoculars: calls $0.25
Pizzaschmied: raises $0.50 to $0.75
bumts1bum: folds 
Galaktyczni: folds 
Roosinups: calls $0.75
gaiggibeliin: calls $0.50
barnoculars: calls $0.50
*** FLOP *** [Ad Kh Ts]
barnoculars: checks 
Pizzaschmied: checks 
Roosinups: checks 
gaiggibeliin: checks 
*** TURN *** [Ad Kh Ts] [9h]
barnoculars: checks 
Pizzaschmied: bets $2.14
Roosinups: calls $2.14
gaiggibeliin: calls $2.14
barnoculars: calls $2.14
*** RIVER *** [Ad Kh Ts 9h] [Qh]
barnoculars: checks 
Pizzaschmied: checks 
Roosinups: bets $4
gaiggibeliin: raises $10.61 to $14.61
barnoculars: folds 
Pizzaschmied: folds 
Roosinups: calls $10.61
*** SHOW DOWN ***
gaiggibeliin: shows [7h 6h] (a flush, King high)
Roosinups: mucks hand 
gaiggibeliin collected $40.28 from pot
*** SUMMARY ***
Total pot $42.28 | Rake $2 
Board [Ad Kh Ts 9h Qh]
Seat 1: barnoculars folded on the River
Seat 2: Pizzaschmied folded on the River
Seat 3: bumts1bum folded before Flop (didn't bet)
Seat 4: Galaktyczni folded before Flop (didn't bet)
Seat 5: Roosinups mucked [Jh 8c]
Seat 6: gaiggibeliin (button blind) showed [7h 6h] and won ($40.28) with a flush, King high



PokerStars Hand #195825460560:  6+ Hold'em No Limit (Button Blind $0.25 - Ante $0.25  USD) - 2019/01/16 19:12:13 EET [2019/01/16 12:12:13 ET]
Table 'Saiph III' 6-max Seat #1 is the button
Seat 1: barnoculars ($46.11 in chips) 
Seat 2: Pizzaschmied ($94.80 in chips) 
Seat 3: bumts1bum ($109.51 in chips) 
Seat 4: Galaktyczni ($49.75 in chips) 
Seat 5: Roosinups ($39.16 in chips) 
Seat 6: gaiggibeliin ($72.28 in chips) 
barnoculars: posts the ante $0.25
Pizzaschmied: posts the ante $0.25
bumts1bum: posts the ante $0.25
Galaktyczni: posts the ante $0.25
Roosinups: posts the ante $0.25
gaiggibeliin: posts the ante $0.25
barnoculars: posts button blind $0.25
*** HOLE CARDS ***
Dealt to gaiggibeliin [6s Jh]
Pizzaschmied: folds 
bumts1bum: folds 
Galaktyczni: folds 
Roosinups: folds 
gaiggibeliin: calls $0.25
barnoculars: raises $2 to $2.25
gaiggibeliin: folds 
Uncalled bet ($2) returned to barnoculars
barnoculars collected $2 from pot
barnoculars: doesn't show hand 
*** SUMMARY ***
Total pot $2 | Rake $0 
Seat 1: barnoculars (button blind) collected ($2)
Seat 2: Pizzaschmied folded before Flop (didn't bet)
Seat 3: bumts1bum folded before Flop (didn't bet)
Seat 4: Galaktyczni folded before Flop (didn't bet)
Seat 5: Roosinups folded before Flop (didn't bet)
Seat 6: gaiggibeliin folded before Flop



PokerStars Hand #195825476293:  6+ Hold'em No Limit (Button Blind $0.25 - Ante $0.25  USD) - 2019/01/16 19:12:35 EET [2019/01/16 12:12:35 ET]
Table 'Saiph III' 6-max Seat #2 is the button
Seat 1: barnoculars ($47.61 in chips) 
Seat 2: Pizzaschmied ($94.55 in chips) 
Seat 3: bumts1bum ($109.26 in chips) 
Seat 4: Galaktyczni ($49.50 in chips) 
Seat 5: Roosinups ($38.91 in chips) 
Seat 6: gaiggibeliin ($71.78 in chips) 
barnoculars: posts the ante $0.25
Pizzaschmied: posts the ante $0.25
bumts1bum: posts the ante $0.25
Galaktyczni: posts the ante $0.25
Roosinups: posts the ante $0.25
gaiggibeliin: posts the ante $0.25
Pizzaschmied: posts button blind $0.25
*** HOLE CARDS ***
Dealt to gaiggibeliin [8c Tc]
bumts1bum: raises $1.25 to $1.50
Galaktyczni: folds 
Roosinups: calls $1.50
gaiggibeliin: folds 
barnoculars: folds 
Pizzaschmied: folds 
*** FLOP *** [Jc Ad 6s]
bumts1bum: bets $2.20
Roosinups: folds 
Uncalled bet ($2.20) returned to bumts1bum
bumts1bum collected $4.51 from pot
bumts1bum: doesn't show hand 
*** SUMMARY ***
Total pot $4.75 | Rake $0.24 
Board [Jc Ad 6s]
Seat 1: barnoculars folded before Flop (didn't bet)
Seat 2: Pizzaschmied (button blind) folded before Flop
Seat 3: bumts1bum collected ($4.51)
Seat 4: Galaktyczni folded before Flop (didn't bet)
Seat 5: Roosinups folded on the Flop
Seat 6: gaiggibeliin folded before Flop (didn't bet)



PokerStars Hand #195825489459:  6+ Hold'em No Limit (Button Blind $0.25 - Ante $0.25  USD) - 2019/01/16 19:12:54 EET [2019/01/16 12:12:54 ET]
Table 'Saiph III' 6-max Seat #3 is the button
Seat 1: barnoculars ($47.36 in chips) 
Seat 2: Pizzaschmied ($94.05 in chips) 
Seat 3: bumts1bum ($112.02 in chips) 
Seat 4: Galaktyczni ($49.25 in chips) 
Seat 5: Roosinups ($37.16 in chips) 
Seat 6: gaiggibeliin ($71.53 in chips) 
barnoculars: posts the ante $0.25
Pizzaschmied: posts the ante $0.25
bumts1bum: posts the ante $0.25
Galaktyczni: posts the ante $0.25
Roosinups: posts the ante $0.25
gaiggibeliin: posts the ante $0.25
bumts1bum: posts button blind $0.25
*** HOLE CARDS ***
Dealt to gaiggibeliin [Ac Ts]
Galaktyczni: folds 
Roosinups: folds 
gaiggibeliin: calls $0.25
barnoculars: raises $2.25 to $2.50
Pizzaschmied: calls $2.50
bumts1bum: folds 
gaiggibeliin: calls $2.25
*** FLOP *** [Jc 7c 9d]
gaiggibeliin: checks 
barnoculars: checks 
Pizzaschmied: checks 
*** TURN *** [Jc 7c 9d] [7s]
gaiggibeliin: checks 
barnoculars: bets $5.86
Pizzaschmied: folds 
gaiggibeliin: folds 
Uncalled bet ($5.86) returned to barnoculars
barnoculars collected $8.79 from pot
barnoculars: doesn't show hand 
*** SUMMARY ***
Total pot $9.25 | Rake $0.46 
Board [Jc 7c 9d 7s]
Seat 1: barnoculars collected ($8.79)
Seat 2: Pizzaschmied folded on the Turn
Seat 3: bumts1bum (button blind) folded before Flop
Seat 4: Galaktyczni folded before Flop (didn't bet)
Seat 5: Roosinups folded before Flop (didn't bet)
Seat 6: gaiggibeliin folded on the Turn



PokerStars Hand #195825542152:  6+ Hold'em No Limit (Button Blind $0.25 - Ante $0.25  USD) - 2019/01/16 19:14:10 EET [2019/01/16 12:14:10 ET]
Table 'Saiph III' 6-max Seat #4 is the button
Seat 1: barnoculars ($53.40 in chips) 
Seat 2: Pizzaschmied ($91.30 in chips) 
Seat 3: bumts1bum ($111.52 in chips) 
Seat 4: Galaktyczni ($49 in chips) 
Seat 5: Roosinups ($36.91 in chips) 
Seat 6: gaiggibeliin ($68.78 in chips) 
barnoculars: posts the ante $0.25
Pizzaschmied: posts the ante $0.25
bumts1bum: posts the ante $0.25
Galaktyczni: posts the ante $0.25
Roosinups: posts the ante $0.25
gaiggibeliin: posts the ante $0.25
Galaktyczni: posts button blind $0.25
*** HOLE CARDS ***
Dealt to gaiggibeliin [Jd 9h]
Roosinups: raises $1 to $1.25
gaiggibeliin: folds 
barnoculars: folds 
Pizzaschmied: folds 
bumts1bum: folds 
Galaktyczni: calls $1
*** FLOP *** [Qc Kc 7h]
Roosinups: bets $2
Galaktyczni: folds 
Uncalled bet ($2) returned to Roosinups
Roosinups collected $3.80 from pot
Roosinups: doesn't show hand 
*** SUMMARY ***
Total pot $4 | Rake $0.20 
Board [Qc Kc 7h]
Seat 1: barnoculars folded before Flop (didn't bet)
Seat 2: Pizzaschmied folded before Flop (didn't bet)
Seat 3: bumts1bum folded before Flop (didn't bet)
Seat 4: Galaktyczni (button blind) folded on the Flop
Seat 5: Roosinups collected ($3.80)
Seat 6: gaiggibeliin folded before Flop (didn't bet)



PokerStars Hand #195825572513:  6+ Hold'em No Limit (Button Blind $0.25 - Ante $0.25  USD) - 2019/01/16 19:14:54 EET [2019/01/16 12:14:54 ET]
Table 'Saiph III' 6-max Seat #5 is the button
Seat 1: barnoculars ($53.15 in chips) 
Seat 2: Pizzaschmied ($91.05 in chips) 
Seat 3: bumts1bum ($111.27 in chips) 
Seat 4: Galaktyczni ($47.50 in chips) 
Seat 5: Roosinups ($39.21 in chips) 
Seat 6: gaiggibeliin ($68.53 in chips) 
barnoculars: posts the ante $0.25
Pizzaschmied: posts the ante $0.25
bumts1bum: posts the ante $0.25
Galaktyczni: posts the ante $0.25
Roosinups: posts the ante $0.25
gaiggibeliin: posts the ante $0.25
Roosinups: posts button blind $0.25
*** HOLE CARDS ***
Dealt to gaiggibeliin [6h 8d]
gaiggibeliin: folds 
barnoculars: folds 
Pizzaschmied: raises $0.50 to $0.75
bumts1bum: folds 
Galaktyczni: folds 
bumts1bum leaves the table
Roosinups: calls $0.50
*** FLOP *** [Qh Ts Tc]
Pizzaschmied: checks 
Roosinups: checks 
*** TURN *** [Qh Ts Tc] [Ad]
Pizzaschmied: bets $1.43
Roosinups: folds 
Uncalled bet ($1.43) returned to Pizzaschmied
Pizzaschmied collected $2.85 from pot
Pizzaschmied: doesn't show hand 
*** SUMMARY ***
Total pot $3 | Rake $0.15 
Board [Qh Ts Tc Ad]
Seat 1: barnoculars folded before Flop (didn't bet)
Seat 2: Pizzaschmied collected ($2.85)
Seat 3: bumts1bum folded before Flop (didn't bet)
Seat 4: Galaktyczni folded before Flop (didn't bet)
Seat 5: Roosinups (button blind) folded on the Turn
Seat 6: gaiggibeliin folded before Flop (didn't bet)



PokerStars Hand #195825588114:  6+ Hold'em No Limit (Button Blind $0.25 - Ante $0.25  USD) - 2019/01/16 19:15:16 EET [2019/01/16 12:15:16 ET]
Table 'Saiph III' 6-max Seat #6 is the button
Seat 1: barnoculars ($52.90 in chips) 
Seat 2: Pizzaschmied ($92.90 in chips) 
Seat 4: Galaktyczni ($47.25 in chips) 
Seat 5: Roosinups ($38.21 in chips) 
Seat 6: gaiggibeliin ($68.28 in chips) 
barnoculars: posts the ante $0.25
Pizzaschmied: posts the ante $0.25
Galaktyczni: posts the ante $0.25
Roosinups: posts the ante $0.25
gaiggibeliin: posts the ante $0.25
gaiggibeliin: posts button blind $0.25
*** HOLE CARDS ***
Dealt to gaiggibeliin [7s 7h]
barnoculars: folds 
Pizzaschmied: raises $0.25 to $0.50
Galaktyczni: folds 
Roosinups: calls $0.50
gaiggibeliin: calls $0.25
*** FLOP *** [Qs Th Kh]
Pizzaschmied: bets $2.61
Roosinups: folds 
gaiggibeliin: folds 
Uncalled bet ($2.61) returned to Pizzaschmied
Pizzaschmied collected $2.61 from pot
Pizzaschmied: doesn't show hand 
*** SUMMARY ***
Total pot $2.75 | Rake $0.14 
Board [Qs Th Kh]
Seat 1: barnoculars folded before Flop (didn't bet)
Seat 2: Pizzaschmied collected ($2.61)
Seat 4: Galaktyczni folded before Flop (didn't bet)
Seat 5: Roosinups folded on the Flop
Seat 6: gaiggibeliin (button blind) folded on the Flop



PokerStars Hand #195825606063:  6+ Hold'em No Limit (Button Blind $0.25 - Ante $0.25  USD) - 2019/01/16 19:15:42 EET [2019/01/16 12:15:42 ET]
Table 'Saiph III' 6-max Seat #1 is the button
Seat 1: barnoculars ($52.65 in chips) 
Seat 2: Pizzaschmied ($94.76 in chips) 
Seat 4: Galaktyczni ($47 in chips) 
Seat 5: Roosinups ($37.46 in chips) 
Seat 6: gaiggibeliin ($67.53 in chips) 
barnoculars: posts the ante $0.25
Pizzaschmied: posts the ante $0.25
Galaktyczni: posts the ante $0.25
Roosinups: posts the ante $0.25
gaiggibeliin: posts the ante $0.25
barnoculars: posts button blind $0.25
*** HOLE CARDS ***
Dealt to gaiggibeliin [Th Jh]
Pizzaschmied: raises $0.25 to $0.50
Galaktyczni: folds 
Roosinups: raises $1 to $1.50
gaiggibeliin: calls $1.50
barnoculars: raises $6.25 to $7.75
Pizzaschmied: folds 
Roosinups: calls $6.25
gaiggibeliin: calls $6.25
*** FLOP *** [Js 6s 6h]
Roosinups: bets $29.46 and is all-in
redheadmad joins the table at seat #3 
gaiggibeliin: folds 
barnoculars: calls $29.46
*** TURN *** [Js 6s 6h] [Ah]
*** RIVER *** [Js 6s 6h Ah] [Jc]
*** SHOW DOWN ***
Roosinups: shows [Ts 8s] (two pair, Jacks and Sixes)
barnoculars: shows [Kd Ks] (two pair, Kings and Jacks)
barnoculars collected $81.92 from pot
*** SUMMARY ***
Total pot $83.92 | Rake $2 
Board [Js 6s 6h Ah Jc]
Seat 1: barnoculars (button blind) showed [Kd Ks] and won ($81.92) with two pair, Kings and Jacks
Seat 2: Pizzaschmied folded before Flop
Seat 4: Galaktyczni folded before Flop (didn't bet)
Seat 5: Roosinups showed [Ts 8s] and lost with two pair, Jacks and Sixes
Seat 6: gaiggibeliin folded on the Flop



PokerStars Hand #195825645744:  6+ Hold'em No Limit (Button Blind $0.25 - Ante $0.25  USD) - 2019/01/16 19:16:33 EET [2019/01/16 12:16:33 ET]
Table 'Saiph III' 6-max Seat #2 is the button
Seat 1: barnoculars ($97.11 in chips) 
Seat 2: Pizzaschmied ($94.01 in chips) 
Seat 3: redheadmad ($50 in chips) 
Seat 4: Galaktyczni ($46.75 in chips) 
Seat 6: gaiggibeliin ($59.53 in chips) 
barnoculars: posts the ante $0.25
Pizzaschmied: posts the ante $0.25
redheadmad: posts the ante $0.25
Galaktyczni: posts the ante $0.25
gaiggibeliin: posts the ante $0.25
Pizzaschmied: posts button blind $0.25
*** HOLE CARDS ***
Dealt to gaiggibeliin [Tc 6s]
redheadmad: raises $0.50 to $0.75
Galaktyczni: folds 
gaiggibeliin: folds 
barnoculars: folds 
Pizzaschmied: calls $0.50
*** FLOP *** [9s Kd 6c]
redheadmad: bets $1.31
Pizzaschmied: calls $1.31
*** TURN *** [9s Kd 6c] [8s]
redheadmad: checks 
Pizzaschmied: checks 
*** RIVER *** [9s Kd 6c 8s] [Qs]
redheadmad: checks 
Pizzaschmied: bets $3.25
redheadmad: calls $3.25
*** SHOW DOWN ***
Pizzaschmied: shows [Ac 6h] (a pair of Sixes)
redheadmad: shows [Kh Jc] (a pair of Kings)
redheadmad collected $11.28 from pot
*** SUMMARY ***
Total pot $11.87 | Rake $0.59 
Board [9s Kd 6c 8s Qs]
Seat 1: barnoculars folded before Flop (didn't bet)
Seat 2: Pizzaschmied (button blind) showed [Ac 6h] and lost with a pair of Sixes
Seat 3: redheadmad showed [Kh Jc] and won ($11.28) with a pair of Kings
Seat 4: Galaktyczni folded before Flop (didn't bet)
Seat 6: gaiggibeliin folded before Flop (didn't bet)



PokerStars Hand #195825674480:  6+ Hold'em No Limit (Button Blind $0.25 - Ante $0.25  USD) - 2019/01/16 19:17:14 EET [2019/01/16 12:17:14 ET]
Table 'Saiph III' 6-max Seat #3 is the button
Seat 1: barnoculars ($96.86 in chips) 
Seat 2: Pizzaschmied ($88.45 in chips) 
Seat 3: redheadmad ($55.72 in chips) 
Seat 4: Galaktyczni ($46.50 in chips) 
Seat 6: gaiggibeliin ($59.28 in chips) 
barnoculars: posts the ante $0.25
Pizzaschmied: posts the ante $0.25
redheadmad: posts the ante $0.25
Galaktyczni: posts the ante $0.25
gaiggibeliin: posts the ante $0.25
redheadmad: posts button blind $0.25
*** HOLE CARDS ***
Dealt to gaiggibeliin [Ts 6d]
Galaktyczni: folds 
gaiggibeliin: folds 
barnoculars: folds 
Pizzaschmied: folds 
Uncalled bet ($0.25) returned to redheadmad
redheadmad collected $1.25 from pot
*** SUMMARY ***
Total pot $1.25 | Rake $0 
Seat 1: barnoculars folded before Flop (didn't bet)
Seat 2: Pizzaschmied folded before Flop (didn't bet)
Seat 3: redheadmad (button blind) collected ($1.25)
Seat 4: Galaktyczni folded before Flop (didn't bet)
Seat 6: gaiggibeliin folded before Flop (didn't bet)



PokerStars Hand #195825679172:  6+ Hold'em No Limit (Button Blind $0.25 - Ante $0.25  USD) - 2019/01/16 19:17:21 EET [2019/01/16 12:17:21 ET]
Table 'Saiph III' 6-max Seat #4 is the button
Seat 1: barnoculars ($96.61 in chips) 
Seat 2: Pizzaschmied ($88.20 in chips) 
Seat 3: redheadmad ($56.72 in chips) 
Seat 4: Galaktyczni ($46.25 in chips) 
Seat 6: gaiggibeliin ($59.03 in chips) 
barnoculars: posts the ante $0.25
Pizzaschmied: posts the ante $0.25
redheadmad: posts the ante $0.25
Galaktyczni: posts the ante $0.25
gaiggibeliin: posts the ante $0.25
Galaktyczni: posts button blind $0.25
*** HOLE CARDS ***
Dealt to gaiggibeliin [Qs Tc]
gaiggibeliin: folds 
barnoculars: folds 
Pizzaschmied: folds 
redheadmad: raises $0.50 to $0.75
Galaktyczni: calls $0.50
*** FLOP *** [8h Ah 8c]
redheadmad: bets $1.46
Galaktyczni: folds 
Uncalled bet ($1.46) returned to redheadmad
redheadmad collected $2.61 from pot
*** SUMMARY ***
Total pot $2.75 | Rake $0.14 
Board [8h Ah 8c]
Seat 1: barnoculars folded before Flop (didn't bet)
Seat 2: Pizzaschmied folded before Flop (didn't bet)
Seat 3: redheadmad collected ($2.61)
Seat 4: Galaktyczni (button blind) folded on the Flop
Seat 6: gaiggibeliin folded before Flop (didn't bet)



PokerStars Hand #195825704203:  6+ Hold'em No Limit (Button Blind $0.25 - Ante $0.25  USD) - 2019/01/16 19:17:57 EET [2019/01/16 12:17:57 ET]
Table 'Saiph III' 6-max Seat #6 is the button
Seat 1: barnoculars ($96.36 in chips) 
Seat 2: Pizzaschmied ($87.95 in chips) 
Seat 3: redheadmad ($58.33 in chips) 
Seat 4: Galaktyczni ($45.25 in chips) 
Seat 5: Roosinups ($50 in chips) 
Seat 6: gaiggibeliin ($58.78 in chips) 
barnoculars: posts the ante $0.25
Pizzaschmied: posts the ante $0.25
redheadmad: posts the ante $0.25
Galaktyczni: posts the ante $0.25
Roosinups: posts the ante $0.25
gaiggibeliin: posts the ante $0.25
gaiggibeliin: posts button blind $0.25
Roosinups: posts big blind $0.25
*** HOLE CARDS ***
Dealt to gaiggibeliin [7s 6d]
barnoculars: folds 
Pizzaschmied: folds 
redheadmad: folds 
Galaktyczni: raises $0.50 to $0.75
Roosinups: folds 
gaiggibeliin: calls $0.50
*** FLOP *** [Ac Js 8s]
Galaktyczni: bets $1.55
gaiggibeliin: folds 
Uncalled bet ($1.55) returned to Galaktyczni
Galaktyczni collected $3.09 from pot
Galaktyczni: doesn't show hand 
*** SUMMARY ***
Total pot $3.25 | Rake $0.16 
Board [Ac Js 8s]
Seat 1: barnoculars folded before Flop (didn't bet)
Seat 2: Pizzaschmied folded before Flop (didn't bet)
Seat 3: redheadmad folded before Flop (didn't bet)
Seat 4: Galaktyczni collected ($3.09)
Seat 5: Roosinups folded before Flop (didn't bet)
Seat 6: gaiggibeliin (button blind) folded on the Flop



PokerStars Hand #195825722359:  6+ Hold'em No Limit (Button Blind $0.25 - Ante $0.25  USD) - 2019/01/16 19:18:22 EET [2019/01/16 12:18:22 ET]
Table 'Saiph III' 6-max Seat #1 is the button
Seat 1: barnoculars ($96.11 in chips) 
Seat 2: Pizzaschmied ($87.70 in chips) 
Seat 3: redheadmad ($58.08 in chips) 
Seat 4: Galaktyczni ($47.34 in chips) 
Seat 5: Roosinups ($49.50 in chips) 
Seat 6: gaiggibeliin ($57.78 in chips) 
barnoculars: posts the ante $0.25
Pizzaschmied: posts the ante $0.25
redheadmad: posts the ante $0.25
Galaktyczni: posts the ante $0.25
Roosinups: posts the ante $0.25
gaiggibeliin: posts the ante $0.25
barnoculars: posts button blind $0.25
*** HOLE CARDS ***
Dealt to gaiggibeliin [6c Kh]
Pizzaschmied: folds 
redheadmad: folds 
Galaktyczni: raises $0.50 to $0.75
Roosinups: calls $0.75
gaiggibeliin: folds 
barnoculars: calls $0.50
*** FLOP *** [7c 9h 6s]
Galaktyczni: checks 
Roosinups: checks 
barnoculars: bets $2.37
Galaktyczni: calls $2.37
Roosinups: calls $2.37
*** TURN *** [7c 9h 6s] [8s]
Galaktyczni: checks 
Roosinups: checks 
barnoculars: checks 
*** RIVER *** [7c 9h 6s 8s] [9c]
Galaktyczni: checks 
Roosinups: bets $7
barnoculars: folds 
Galaktyczni: calls $7
*** SHOW DOWN ***
Roosinups: shows [Kd 6d] (two pair, Nines and Sixes)
Galaktyczni: shows [Th Ah] (a straight, Six to Ten)
Galaktyczni collected $23.62 from pot
*** SUMMARY ***
Total pot $24.86 | Rake $1.24 
Board [7c 9h 6s 8s 9c]
Seat 1: barnoculars (button blind) folded on the River
Seat 2: Pizzaschmied folded before Flop (didn't bet)
Seat 3: redheadmad folded before Flop (didn't bet)
Seat 4: Galaktyczni showed [Th Ah] and won ($23.62) with a straight, Six to Ten
Seat 5: Roosinups showed [Kd 6d] and lost with two pair, Nines and Sixes
Seat 6: gaiggibeliin folded before Flop (didn't bet)



PokerStars Hand #195825764165:  6+ Hold'em No Limit (Button Blind $0.25 - Ante $0.25  USD) - 2019/01/16 19:19:21 EET [2019/01/16 12:19:21 ET]
Table 'Saiph III' 6-max Seat #2 is the button
Seat 1: barnoculars ($92.74 in chips) 
Seat 2: Pizzaschmied ($87.45 in chips) 
Seat 3: redheadmad ($57.83 in chips) 
Seat 4: Galaktyczni ($60.59 in chips) 
Seat 5: Roosinups ($39.13 in chips) 
Seat 6: gaiggibeliin ($57.53 in chips) 
barnoculars: posts the ante $0.25
Pizzaschmied: posts the ante $0.25
redheadmad: posts the ante $0.25
Galaktyczni: posts the ante $0.25
Roosinups: posts the ante $0.25
gaiggibeliin: posts the ante $0.25
Pizzaschmied: posts button blind $0.25
*** HOLE CARDS ***
Dealt to gaiggibeliin [Qd Qh]
redheadmad: folds 
Galaktyczni: raises $0.50 to $0.75
Roosinups: folds 
gaiggibeliin: raises $2.25 to $3
barnoculars: folds 
Pizzaschmied: calls $2.75
Galaktyczni: calls $2.25
*** FLOP *** [6d Jd Kd]
Galaktyczni: checks 
Roosinups leaves the table
gaiggibeliin: bets $5.19
Pizzaschmied: calls $5.19
Galaktyczni: folds 
*** TURN *** [6d Jd Kd] [Qs]
gaiggibeliin: bets $10.32
Pizzaschmied: calls $10.32
*** RIVER *** [6d Jd Kd Qs] [7c]
gaiggibeliin: bets $38.77 and is all-in
Pizzaschmied: folds 
Uncalled bet ($38.77) returned to gaiggibeliin
gaiggibeliin collected $39.52 from pot
*** SUMMARY ***
Total pot $41.52 | Rake $2 
Board [6d Jd Kd Qs 7c]
Seat 1: barnoculars folded before Flop (didn't bet)
Seat 2: Pizzaschmied (button blind) folded on the River
Seat 3: redheadmad folded before Flop (didn't bet)
Seat 4: Galaktyczni folded on the Flop
Seat 5: Roosinups folded before Flop (didn't bet)
Seat 6: gaiggibeliin collected ($39.52)



PokerStars Hand #195825829098:  6+ Hold'em No Limit (Button Blind $0.25 - Ante $0.25  USD) - 2019/01/16 19:20:53 EET [2019/01/16 12:20:53 ET]
Table 'Saiph III' 6-max Seat #3 is the button
Seat 1: barnoculars ($92.49 in chips) 
Seat 2: Pizzaschmied ($68.69 in chips) 
Seat 3: redheadmad ($57.58 in chips) 
Seat 4: Galaktyczni ($57.34 in chips) 
Seat 6: gaiggibeliin ($78.29 in chips) 
barnoculars: posts the ante $0.25
Pizzaschmied: posts the ante $0.25
redheadmad: posts the ante $0.25
Galaktyczni: posts the ante $0.25
gaiggibeliin: posts the ante $0.25
redheadmad: posts button blind $0.25
*** HOLE CARDS ***
Dealt to gaiggibeliin [7d 6d]
Galaktyczni: folds 
kofi89 joins the table at seat #5 
gaiggibeliin: raises $1.75 to $2
barnoculars: folds 
Pizzaschmied: calls $2
redheadmad: folds 
*** FLOP *** [8c Ah 8h]
gaiggibeliin: checks 
Pizzaschmied: bets $5.22
gaiggibeliin: folds 
Uncalled bet ($5.22) returned to Pizzaschmied
Pizzaschmied collected $5.22 from pot
Pizzaschmied: doesn't show hand 
*** SUMMARY ***
Total pot $5.50 | Rake $0.28 
Board [8c Ah 8h]
Seat 1: barnoculars folded before Flop (didn't bet)
Seat 2: Pizzaschmied collected ($5.22)
Seat 3: redheadmad (button blind) folded before Flop
Seat 4: Galaktyczni folded before Flop (didn't bet)
Seat 6: gaiggibeliin folded on the Flop



PokerStars Hand #195825856621:  6+ Hold'em No Limit (Button Blind $0.25 - Ante $0.25  USD) - 2019/01/16 19:21:32 EET [2019/01/16 12:21:32 ET]
Table 'Saiph III' 6-max Seat #4 is the button
Seat 1: barnoculars ($92.24 in chips) 
Seat 2: Pizzaschmied ($71.66 in chips) 
Seat 3: redheadmad ($57.08 in chips) 
Seat 4: Galaktyczni ($57.09 in chips) 
Seat 5: kofi89 ($50 in chips) 
Seat 6: gaiggibeliin ($76.04 in chips) 
barnoculars: posts the ante $0.25
Pizzaschmied: posts the ante $0.25
redheadmad: posts the ante $0.25
Galaktyczni: posts the ante $0.25
kofi89: posts the ante $0.25
gaiggibeliin: posts the ante $0.25
Galaktyczni: posts button blind $0.25
*** HOLE CARDS ***
Dealt to gaiggibeliin [7h Qs]
kofi89: folds 
gaiggibeliin: folds 
barnoculars: raises $2 to $2.25
Pizzaschmied: calls $2.25
redheadmad: folds 
Galaktyczni: folds 
*** FLOP *** [Qd Td Th]
barnoculars: bets $1.78
Pizzaschmied: raises $3.22 to $5
barnoculars: raises $9.50 to $14.50
Pizzaschmied: raises $54.66 to $69.16 and is all-in
redheadmad is disconnected 
barnoculars: folds 
Uncalled bet ($54.66) returned to Pizzaschmied
Pizzaschmied collected $33.49 from pot
Pizzaschmied: doesn't show hand 
*** SUMMARY ***
Total pot $35.25 | Rake $1.76 
Board [Qd Td Th]
Seat 1: barnoculars folded on the Flop
Seat 2: Pizzaschmied collected ($33.49)
Seat 3: redheadmad folded before Flop (didn't bet)
Seat 4: Galaktyczni (button blind) folded before Flop
Seat 5: kofi89 folded before Flop (didn't bet)
Seat 6: gaiggibeliin folded before Flop (didn't bet)



PokerStars Hand #195825894213:  6+ Hold'em No Limit (Button Blind $0.25 - Ante $0.25  USD) - 2019/01/16 19:22:26 EET [2019/01/16 12:22:26 ET]
Table 'Saiph III' 6-max Seat #5 is the button
Seat 1: barnoculars ($75.24 in chips) 
Seat 3: redheadmad ($56.83 in chips) 
Seat 4: Galaktyczni ($56.59 in chips) 
Seat 5: kofi89 ($49.75 in chips) 
Seat 6: gaiggibeliin ($75.79 in chips) 
barnoculars: posts the ante $0.25
redheadmad: posts the ante $0.25
Galaktyczni: posts the ante $0.25
kofi89: posts the ante $0.25
gaiggibeliin: posts the ante $0.25
kofi89: posts button blind $0.25
*** HOLE CARDS ***
Dealt to gaiggibeliin [Tc Th]
Pizzaschmied leaves the table
gaiggibeliin: raises $1.75 to $2
barnoculars: folds 
redheadmad: folds 
Galaktyczni: folds 
kofi89: calls $1.75
*** FLOP *** [7h 9h Qs]
gaiggibeliin: checks 
kofi89: bets $3.49
gaiggibeliin: calls $3.49
*** TURN *** [7h 9h Qs] [6h]
gaiggibeliin: checks 
kofi89: bets $8.13
gaiggibeliin: calls $8.13
*** RIVER *** [7h 9h Qs 6h] [Ts]
gaiggibeliin: checks 
kofi89: checks 
*** SHOW DOWN ***
gaiggibeliin: shows [Tc Th] (three of a kind, Tens)
kofi89: mucks hand 
gaiggibeliin collected $27.07 from pot
TheGreatGub joins the table at seat #2 
*** SUMMARY ***
Total pot $28.49 | Rake $1.42 
Board [7h 9h Qs 6h Ts]
Seat 1: barnoculars folded before Flop (didn't bet)
Seat 3: redheadmad folded before Flop (didn't bet)
Seat 4: Galaktyczni folded before Flop (didn't bet)
Seat 5: kofi89 (button blind) mucked [Qd 9s]
Seat 6: gaiggibeliin showed [Tc Th] and won ($27.07) with three of a kind, Tens



PokerStars Hand #195825960849:  6+ Hold'em No Limit (Button Blind $0.25 - Ante $0.25  USD) - 2019/01/16 19:24:00 EET [2019/01/16 12:24:00 ET]
Table 'Saiph III' 6-max Seat #6 is the button
Seat 1: barnoculars ($74.99 in chips) 
Seat 2: TheGreatGub ($50 in chips) 
Seat 3: redheadmad ($56.58 in chips) 
Seat 4: Galaktyczni ($56.34 in chips) 
Seat 5: kofi89 ($35.88 in chips) 
Seat 6: gaiggibeliin ($88.99 in chips) 
barnoculars: posts the ante $0.25
TheGreatGub: posts the ante $0.25
redheadmad: posts the ante $0.25
Galaktyczni: posts the ante $0.25
kofi89: posts the ante $0.25
gaiggibeliin: posts the ante $0.25
gaiggibeliin: posts button blind $0.25
*** HOLE CARDS ***
Dealt to gaiggibeliin [Kc Tc]
barnoculars: calls $0.25
TheGreatGub: folds 
redheadmad: folds 
Galaktyczni: folds 
kofi89: folds 
kofi89 leaves the table
gaiggibeliin: checks 
*** FLOP *** [9d Ks Qd]
barnoculars: checks 
gaiggibeliin: bets $1.27
barnoculars: folds 
Uncalled bet ($1.27) returned to gaiggibeliin
gaiggibeliin collected $1.90 from pot
*** SUMMARY ***
Total pot $2 | Rake $0.10 
Board [9d Ks Qd]
Seat 1: barnoculars folded on the Flop
Seat 2: TheGreatGub folded before Flop (didn't bet)
Seat 3: redheadmad folded before Flop (didn't bet)
Seat 4: Galaktyczni folded before Flop (didn't bet)
Seat 5: kofi89 folded before Flop (didn't bet)
Seat 6: gaiggibeliin (button blind) collected ($1.90)



